Date,county,state,fips,cases,deaths,total
7/10/2022,Autauga,Alabama,1001,16801,217,17018
7/10/2022,Baldwin,Alabama,1003,59743,683,60426
7/10/2022,Barbour,Alabama,1005,5993,99,6092
7/10/2022,Bibb,Alabama,1007,6767,105,6872
7/10/2022,Blount,Alabama,1009,15506,246,15752
7/10/2022,Bullock,Alabama,1011,2501,54,2555
7/10/2022,Butler,Alabama,1013,5333,129,5462
7/10/2022,Calhoun,Alabama,1015,33603,634,34237
7/10/2022,Chambers,Alabama,1017,8940,163,9103
7/10/2022,Cherokee,Alabama,1019,5324,86,5410
7/10/2022,Chilton,Alabama,1021,11436,211,11647
7/10/2022,Choctaw,Alabama,1023,2114,37,2151
7/10/2022,Clarke,Alabama,1025,7372,101,7473
7/10/2022,Clay,Alabama,1027,4266,83,4349
7/10/2022,Cleburne,Alabama,1029,3632,69,3701
7/10/2022,Coffee,Alabama,1031,14370,236,14606
7/10/2022,Colbert,Alabama,1033,17217,262,17479
7/10/2022,Conecuh,Alabama,1035,3008,70,3078
7/10/2022,Coosa,Alabama,1037,3106,59,3165
7/10/2022,Covington,Alabama,1039,9829,235,10064
7/10/2022,Crenshaw,Alabama,1041,4000,102,4102
7/10/2022,Cullman,Alabama,1043,25899,369,26268
7/10/2022,Dale,Alabama,1045,13656,233,13889
7/10/2022,Dallas,Alabama,1047,8904,245,9149
7/10/2022,DeKalb,Alabama,1049,19293,331,19624
7/10/2022,Elmore,Alabama,1051,24794,350,25144
7/10/2022,Escambia,Alabama,1053,10560,173,10733
7/10/2022,Etowah,Alabama,1055,29554,653,30207
7/10/2022,Fayette,Alabama,1057,5092,97,5189
7/10/2022,Franklin,Alabama,1059,10162,140,10302
7/10/2022,Geneva,Alabama,1061,6784,165,6949
7/10/2022,Greene,Alabama,1063,1985,51,2036
7/10/2022,Hale,Alabama,1065,5017,106,5123
7/10/2022,Henry,Alabama,1067,4860,78,4938
7/10/2022,Houston,Alabama,1069,27230,509,27739
7/10/2022,Jackson,Alabama,1071,15513,241,15754
7/10/2022,Jefferson,Alabama,1073,198151,2390,200541
7/10/2022,Lamar,Alabama,1075,3902,65,3967
7/10/2022,Lauderdale,Alabama,1077,25317,400,25717
7/10/2022,Lawrence,Alabama,1079,7936,160,8096
7/10/2022,Lee,Alabama,1081,39839,342,40181
7/10/2022,Limestone,Alabama,1083,26482,298,26780
7/10/2022,Lowndes,Alabama,1085,2775,77,2852
7/10/2022,Macon,Alabama,1087,4151,86,4237
7/10/2022,Madison,Alabama,1089,96424,981,97405
7/10/2022,Marengo,Alabama,1091,5452,108,5560
7/10/2022,Marion,Alabama,1093,8529,153,8682
7/10/2022,Marshall,Alabama,1095,28280,395,28675
7/10/2022,Mobile,Alabama,1097,118114,1671,119785
7/10/2022,Monroe,Alabama,1099,5516,81,5597
7/10/2022,Montgomery,Alabama,1101,59645,958,60603
7/10/2022,Morgan,Alabama,1103,37926,519,38445
7/10/2022,Perry,Alabama,1105,2212,47,2259
7/10/2022,Pickens,Alabama,1107,5451,105,5556
7/10/2022,Pike,Alabama,1109,7846,134,7980
7/10/2022,Randolph,Alabama,1111,5251,75,5326
7/10/2022,Russell,Alabama,1113,10718,96,10814
7/10/2022,Shelby,Alabama,1117,64604,456,65060
7/10/2022,St. Clair,Alabama,1115,26856,418,27274
7/10/2022,Sumter,Alabama,1119,2714,52,2766
7/10/2022,Talladega,Alabama,1121,23381,378,23759
7/10/2022,Tallapoosa,Alabama,1123,11959,237,12196
7/10/2022,Tuscaloosa,Alabama,1125,59752,794,60546
7/10/2022,Walker,Alabama,1127,19574,449,20023
7/10/2022,Washington,Alabama,1129,3894,59,3953
7/10/2022,Wilcox,Alabama,1131,3038,47,3085
7/10/2022,Winston,Alabama,1133,7831,133,7964
7/10/2022,Aleutians East Borough,Alaska,2013,1151,3,1154
7/10/2022,Aleutians West Census Area,Alaska,2016,1815,1,1816
7/10/2022,Anchorage,Alaska,2020,112601,532,113133
7/10/2022,Bethel Census Area,Alaska,2050,10844,41,10885
7/10/2022,Bristol Bay plus Lake and Peninsula,Alaska,,1052,1,1053
7/10/2022,Denali Borough,Alaska,2068,1085,1,1086
7/10/2022,Dillingham Census Area,Alaska,2070,2000,12,2012
7/10/2022,Fairbanks North Star Borough,Alaska,2090,30068,142,30210
7/10/2022,Haines Borough,Alaska,2100,695,1,696
7/10/2022,Juneau City and Borough,Alaska,2110,10258,19,10277
7/10/2022,Kenai Peninsula Borough,Alaska,2122,19564,102,19666
7/10/2022,Ketchikan Gateway Borough,Alaska,2130,4758,19,4777
7/10/2022,Kodiak Island Borough,Alaska,2150,5281,12,5293
7/10/2022,Kusilvak Census Area,Alaska,2158,4313,14,4327
7/10/2022,Matanuska-Susitna Borough,Alaska,2170,36788,239,37027
7/10/2022,Nome Census Area,Alaska,2180,6342,5,6347
7/10/2022,North Slope Borough,Alaska,2185,4770,13,4783
7/10/2022,Northwest Arctic Borough,Alaska,2188,5008,14,5022
7/10/2022,Petersburg Borough,Alaska,2195,837,5,842
7/10/2022,Prince of Wales-Hyder Census Area,Alaska,2198,1597,8,1605
7/10/2022,Sitka City and Borough,Alaska,2220,2924,5,2929
7/10/2022,Skagway Municipality,Alaska,2230,455,0,455
7/10/2022,Southeast Fairbanks Census Area,Alaska,2240,2165,20,2185
7/10/2022,Unknown,Alaska,,3935,1,3936
7/10/2022,Valdez-Cordova Census Area,Alaska,2261,3250,20,3270
7/10/2022,Wrangell City and Borough,Alaska,2275,653,1,654
7/10/2022,Yakutat plus Hoonah-Angoon,Alaska,,700,5,705
7/10/2022,Yukon-Koyukuk Census Area,Alaska,2290,1542,10,1552
7/10/2022,Unknown,American Samoa,,6353,31,6384
7/10/2022,Apache,Arizona,4001,27698,616,28314
7/10/2022,Cochise,Arizona,4003,33589,578,34167
7/10/2022,Coconino,Arizona,4005,46865,480,47345
7/10/2022,Gila,Arizona,4007,18052,386,18438
7/10/2022,Graham,Arizona,4009,12334,180,12514
7/10/2022,Greenlee,Arizona,4011,2286,39,2325
7/10/2022,La Paz,Arizona,4012,5430,145,5575
7/10/2022,Maricopa,Arizona,4013,1355204,17526,1372730
7/10/2022,Mohave,Arizona,4015,60284,1481,61765
7/10/2022,Navajo,Arizona,4017,40629,914,41543
7/10/2022,Pima,Arizona,4019,272138,3895,276033
7/10/2022,Pinal,Arizona,4021,139128,1679,140807
7/10/2022,Santa Cruz,Arizona,4023,17178,232,17410
7/10/2022,Yavapai,Arizona,4025,51183,1234,52417
7/10/2022,Yuma,Arizona,4027,63767,1187,64954
7/10/2022,Arkansas,Arkansas,5001,5949,78,6027
7/10/2022,Ashley,Arkansas,5003,5381,69,5450
7/10/2022,Baxter,Arkansas,5005,9401,251,9652
7/10/2022,Benton,Arkansas,5007,69816,874,70690
7/10/2022,Boone,Arkansas,5009,9867,181,10048
7/10/2022,Bradley,Arkansas,5011,3123,53,3176
7/10/2022,Calhoun,Arkansas,5013,1004,11,1015
7/10/2022,Carroll,Arkansas,5015,6412,106,6518
7/10/2022,Chicot,Arkansas,5017,2838,59,2897
7/10/2022,Clark,Arkansas,5019,5671,82,5753
7/10/2022,Clay,Arkansas,5021,4320,94,4414
7/10/2022,Cleburne,Arkansas,5023,6728,129,6857
7/10/2022,Cleveland,Arkansas,5025,2368,36,2404
7/10/2022,Columbia,Arkansas,5027,5663,97,5760
7/10/2022,Conway,Arkansas,5029,5696,65,5761
7/10/2022,Craighead,Arkansas,5031,39577,335,39912
7/10/2022,Crawford,Arkansas,5033,16509,252,16761
7/10/2022,Crittenden,Arkansas,5035,14984,227,15211
7/10/2022,Cross,Arkansas,5037,5062,87,5149
7/10/2022,Dallas,Arkansas,5039,1850,32,1882
7/10/2022,Desha,Arkansas,5041,3183,41,3224
7/10/2022,Drew,Arkansas,5043,4819,71,4890
7/10/2022,Faulkner,Arkansas,5045,37101,320,37421
7/10/2022,Franklin,Arkansas,5047,3931,73,4004
7/10/2022,Fulton,Arkansas,5049,2782,94,2876
7/10/2022,Garland,Arkansas,5051,24211,516,24727
7/10/2022,Grant,Arkansas,5053,4618,62,4680
7/10/2022,Greene,Arkansas,5055,16731,178,16909
7/10/2022,Hempstead,Arkansas,5057,4852,70,4922
7/10/2022,Hot Spring,Arkansas,5059,11584,138,11722
7/10/2022,Howard,Arkansas,5061,3912,52,3964
7/10/2022,Independence,Arkansas,5063,10986,215,11201
7/10/2022,Izard,Arkansas,5065,4090,71,4161
7/10/2022,Jackson,Arkansas,5067,6337,64,6401
7/10/2022,Jefferson,Arkansas,5069,19559,278,19837
7/10/2022,Johnson,Arkansas,5071,7084,88,7172
7/10/2022,Lafayette,Arkansas,5073,1332,31,1363
7/10/2022,Lawrence,Arkansas,5075,5562,82,5644
7/10/2022,Lee,Arkansas,5077,3008,61,3069
7/10/2022,Lincoln,Arkansas,5079,5008,69,5077
7/10/2022,Little River,Arkansas,5081,3380,106,3486
7/10/2022,Logan,Arkansas,5083,5275,79,5354
7/10/2022,Lonoke,Arkansas,5085,20906,249,21155
7/10/2022,Madison,Arkansas,5087,4175,65,4240
7/10/2022,Marion,Arkansas,5089,3575,89,3664
7/10/2022,Miller,Arkansas,5091,9996,182,10178
7/10/2022,Mississippi,Arkansas,5093,14111,214,14325
7/10/2022,Monroe,Arkansas,5095,2021,36,2057
7/10/2022,Montgomery,Arkansas,5097,1590,56,1646
7/10/2022,Nevada,Arkansas,5099,2313,45,2358
7/10/2022,Newton,Arkansas,5101,1780,49,1829
7/10/2022,Ouachita,Arkansas,5103,5795,109,5904
7/10/2022,Perry,Arkansas,5105,2629,38,2667
7/10/2022,Phillips,Arkansas,5107,5043,99,5142
7/10/2022,Pike,Arkansas,5109,2675,44,2719
7/10/2022,Poinsett,Arkansas,5111,8415,130,8545
7/10/2022,Polk,Arkansas,5113,4252,151,4403
7/10/2022,Pope,Arkansas,5115,18904,213,19117
7/10/2022,Prairie,Arkansas,5117,2031,42,2073
7/10/2022,Pulaski,Arkansas,5119,110894,1191,112085
7/10/2022,Randolph,Arkansas,5121,5432,90,5522
7/10/2022,Saline,Arkansas,5125,32433,347,32780
7/10/2022,Scott,Arkansas,5127,2422,44,2466
7/10/2022,Searcy,Arkansas,5129,2218,48,2266
7/10/2022,Sebastian,Arkansas,5131,34415,529,34944
7/10/2022,Sevier,Arkansas,5133,6197,75,6272
7/10/2022,Sharp,Arkansas,5135,4914,108,5022
7/10/2022,St. Francis,Arkansas,5123,7551,97,7648
7/10/2022,Stone,Arkansas,5137,3124,68,3192
7/10/2022,Union,Arkansas,5139,9620,183,9803
7/10/2022,Unknown,Arkansas,,28359,0,28359
7/10/2022,Van Buren,Arkansas,5141,3650,62,3712
7/10/2022,Washington,Arkansas,5143,71648,637,72285
7/10/2022,White,Arkansas,5145,23213,303,23516
7/10/2022,Woodruff,Arkansas,5147,1819,31,1850
7/10/2022,Yell,Arkansas,5149,6966,107,7073
7/10/2022,Alameda,California,6001,330663,1932,332595
7/10/2022,Alpine,California,6003,130,0,130
7/10/2022,Amador,California,6005,10117,87,10204
7/10/2022,Butte,California,6007,43944,438,44382
7/10/2022,Calaveras,California,6009,8335,125,8460
7/10/2022,Colusa,California,6011,4759,22,4781
7/10/2022,Contra Costa,California,6013,242156,1351,243507
7/10/2022,Del Norte,California,6015,7035,54,7089
7/10/2022,El Dorado,California,6017,33887,218,34105
7/10/2022,Fresno,California,6019,277146,2786,279932
7/10/2022,Glenn,California,6021,6978,67,7045
7/10/2022,Humboldt,California,6023,23960,149,24109
7/10/2022,Imperial,California,6025,71901,943,72844
7/10/2022,Inyo,California,6027,5013,56,5069
7/10/2022,Kern,California,6029,261393,2478,263871
7/10/2022,Kings,California,6031,58563,449,59012
7/10/2022,Lake,California,6033,12722,140,12862
7/10/2022,Lassen,California,6035,11145,70,11215
7/10/2022,Los Angeles,California,6037,3160736,32413,3193149
7/10/2022,Madera,California,6039,47006,372,47378
7/10/2022,Marin,California,6041,46049,302,46351
7/10/2022,Mariposa,California,6043,3756,36,3792
7/10/2022,Mendocino,California,6045,18456,128,18584
7/10/2022,Merced,California,6047,76553,832,77385
7/10/2022,Modoc,California,6049,1071,9,1080
7/10/2022,Mono,California,6051,3316,7,3323
7/10/2022,Monterey,California,6053,104760,762,105522
7/10/2022,Napa,California,6055,31115,145,31260
7/10/2022,Nevada,California,6057,19209,131,19340
7/10/2022,Orange,California,6059,662789,7145,669934
7/10/2022,Placer,California,6061,78886,632,79518
7/10/2022,Plumas,California,6063,3747,13,3760
7/10/2022,Riverside,California,6065,669805,6560,676365
7/10/2022,Sacramento,California,6067,350441,3272,353713
7/10/2022,San Benito,California,6069,15371,100,15471
7/10/2022,San Bernardino,California,6071,637572,7893,645465
7/10/2022,San Diego,California,6073,906672,5357,912029
7/10/2022,San Francisco,California,6075,172806,914,173720
7/10/2022,San Joaquin,California,6077,194349,2257,196606
7/10/2022,San Luis Obispo,California,6079,64541,498,65039
7/10/2022,San Mateo,California,6081,162060,776,162836
7/10/2022,Santa Barbara,California,6083,101994,697,102691
7/10/2022,Santa Clara,California,6085,405248,2361,407609
7/10/2022,Santa Cruz,California,6087,59334,266,59600
7/10/2022,Shasta,California,6089,39176,660,39836
7/10/2022,Sierra,California,6091,349,4,353
7/10/2022,Siskiyou,California,6093,8075,107,8182
7/10/2022,Solano,California,6095,102591,455,103046
7/10/2022,Sonoma,California,6097,102871,500,103371
7/10/2022,Stanislaus,California,6099,146223,1694,147917
7/10/2022,Sutter,California,6101,24561,235,24796
7/10/2022,Tehama,California,6103,15531,205,15736
7/10/2022,Trinity,California,6105,1580,20,1600
7/10/2022,Tulare,California,6107,145134,1508,146642
7/10/2022,Tuolumne,California,6109,15148,194,15342
7/10/2022,Ventura,California,6111,203800,1519,205319
7/10/2022,Yolo,California,6113,48077,324,48401
7/10/2022,Yuba,California,6115,19293,125,19418
7/10/2022,Adams,Colorado,8001,149388,1406,150794
7/10/2022,Alamosa,Colorado,8003,5049,62,5111
7/10/2022,Arapahoe,Colorado,8005,174689,1317,176006
7/10/2022,Archuleta,Colorado,8007,3102,16,3118
7/10/2022,Baca,Colorado,8009,895,14,909
7/10/2022,Bent,Colorado,8011,2662,47,2709
7/10/2022,Boulder,Colorado,8013,78659,381,79040
7/10/2022,Broomfield,Colorado,8014,15937,119,16056
7/10/2022,Chaffee,Colorado,8015,5105,49,5154
7/10/2022,Cheyenne,Colorado,8017,329,9,338
7/10/2022,Clear Creek,Colorado,8019,1755,12,1767
7/10/2022,Conejos,Colorado,8021,2000,56,2056
7/10/2022,Costilla,Colorado,8023,794,18,812
7/10/2022,Crowley,Colorado,8025,3399,31,3430
7/10/2022,Custer,Colorado,8027,723,22,745
7/10/2022,Delta,Colorado,8029,6551,141,6692
7/10/2022,Denver,Colorado,8031,199118,1400,200518
7/10/2022,Dolores,Colorado,8033,377,8,385
7/10/2022,Douglas,Colorado,8035,89951,472,90423
7/10/2022,Eagle,Colorado,8037,17367,36,17403
7/10/2022,Elbert,Colorado,8039,5249,41,5290
7/10/2022,El Paso,Colorado,8041,208556,1744,210300
7/10/2022,Fremont,Colorado,8043,16453,190,16643
7/10/2022,Garfield,Colorado,8045,16239,94,16333
7/10/2022,Gilpin,Colorado,8047,1071,5,1076
7/10/2022,Grand,Colorado,8049,3764,28,3792
7/10/2022,Gunnison,Colorado,8051,3626,14,3640
7/10/2022,Hinsdale,Colorado,8053,141,0,141
7/10/2022,Huerfano,Colorado,8055,1569,37,1606
7/10/2022,Jackson,Colorado,8057,183,0,183
7/10/2022,Jefferson,Colorado,8059,142716,1390,144106
7/10/2022,Kiowa,Colorado,8061,347,6,353
7/10/2022,Kit Carson,Colorado,8063,1686,33,1719
7/10/2022,Lake,Colorado,8065,2010,2,2012
7/10/2022,La Plata,Colorado,8067,14046,89,14135
7/10/2022,Larimer,Colorado,8069,92545,526,93071
7/10/2022,Las Animas,Colorado,8071,3806,45,3851
7/10/2022,Lincoln,Colorado,8073,2272,10,2282
7/10/2022,Logan,Colorado,8075,7778,112,7890
7/10/2022,Mesa,Colorado,8077,45703,588,46291
7/10/2022,Mineral,Colorado,8079,266,2,268
7/10/2022,Moffat,Colorado,8081,3241,53,3294
7/10/2022,Montezuma,Colorado,8083,6558,83,6641
7/10/2022,Montrose,Colorado,8085,10033,168,10201
7/10/2022,Morgan,Colorado,8087,6048,138,6186
7/10/2022,Otero,Colorado,8089,4618,130,4748
7/10/2022,Ouray,Colorado,8091,983,6,989
7/10/2022,Park,Colorado,8093,3159,21,3180
7/10/2022,Phillips,Colorado,8095,929,19,948
7/10/2022,Pitkin,Colorado,8097,7339,7,7346
7/10/2022,Prowers,Colorado,8099,2736,51,2787
7/10/2022,Pueblo,Colorado,8101,52123,812,52935
7/10/2022,Rio Blanco,Colorado,8103,1842,13,1855
7/10/2022,Rio Grande,Colorado,8105,3124,46,3170
7/10/2022,Routt,Colorado,8107,7120,25,7145
7/10/2022,Saguache,Colorado,8109,1315,12,1327
7/10/2022,San Juan,Colorado,8111,260,0,260
7/10/2022,San Miguel,Colorado,8113,2490,8,2498
7/10/2022,Sedgwick,Colorado,8115,505,10,515
7/10/2022,Summit,Colorado,8117,11000,14,11014
7/10/2022,Teller,Colorado,8119,5348,58,5406
7/10/2022,Washington,Colorado,8121,1093,29,1122
7/10/2022,Weld,Colorado,8123,94077,715,94792
7/10/2022,Yuma,Colorado,8125,2047,24,2071
7/10/2022,Fairfield,Connecticut,9001,229212,2750,231962
7/10/2022,Hartford,Connecticut,9003,201772,3192,204964
7/10/2022,Litchfield,Connecticut,9005,35657,469,36126
7/10/2022,Middlesex,Connecticut,9007,33135,488,33623
7/10/2022,New Haven,Connecticut,9009,219659,2879,222538
7/10/2022,New London,Connecticut,9011,62528,681,63209
7/10/2022,Tolland,Connecticut,9013,23832,284,24116
7/10/2022,Unknown,Connecticut,,2665,2,2667
7/10/2022,Windham,Connecticut,9015,28006,310,28316
7/10/2022,Kent,Delaware,10001,55670,664,56334
7/10/2022,New Castle,Delaware,10003,163226,1456,164682
7/10/2022,Sussex,Delaware,10005,67191,878,68069
7/10/2022,Unknown,Delaware,,991,0,991
7/10/2022,District of Columbia,District of Columbia,11001,158281,1352,159633
7/10/2022,Alachua,Florida,12001,75246,688,75934
7/10/2022,Baker,Florida,12003,9007,143,9150
7/10/2022,Bay,Florida,12005,48372,832,49204
7/10/2022,Bradford,Florida,12007,7841,150,7991
7/10/2022,Brevard,Florida,12009,149620,2178,151798
7/10/2022,Broward,Florida,12011,675409,6004,681413
7/10/2022,Calhoun,Florida,12013,4226,99,4325
7/10/2022,Charlotte,Florida,12015,39945,834,40779
7/10/2022,Citrus,Florida,12017,32541,995,33536
7/10/2022,Clay,Florida,12019,57483,873,58356
7/10/2022,Collier,Florida,12021,91157,1021,92178
7/10/2022,Columbia,Florida,12023,22024,410,22434
7/10/2022,DeSoto,Florida,12027,9935,152,10087
7/10/2022,Dixie,Florida,12029,4237,71,4308
7/10/2022,Duval,Florida,12031,273824,3471,277295
7/10/2022,Escambia,Florida,12033,82597,1336,83933
7/10/2022,Flagler,Florida,12035,24722,369,25091
7/10/2022,Franklin,Florida,12037,3193,53,3246
7/10/2022,Gadsden,Florida,12039,14475,210,14685
7/10/2022,Gilchrist,Florida,12041,4788,99,4887
7/10/2022,Glades,Florida,12043,2078,36,2114
7/10/2022,Gulf,Florida,12045,4482,80,4562
7/10/2022,Hamilton,Florida,12047,3954,56,4010
7/10/2022,Hardee,Florida,12049,9015,125,9140
7/10/2022,Hendry,Florida,12051,12250,161,12411
7/10/2022,Hernando,Florida,12053,45977,1118,47095
7/10/2022,Highlands,Florida,12055,25908,697,26605
7/10/2022,Hillsborough,Florida,12057,413077,3894,416971
7/10/2022,Holmes,Florida,12059,5660,90,5750
7/10/2022,Indian River,Florida,12061,36364,673,37037
7/10/2022,Jackson,Florida,12063,15495,284,15779
7/10/2022,Jefferson,Florida,12065,4193,61,4254
7/10/2022,Lafayette,Florida,12067,2879,61,2940
7/10/2022,Lake,Florida,12069,93539,1549,95088
7/10/2022,Lee,Florida,12071,206862,2213,209075
7/10/2022,Leon,Florida,12073,93612,679,94291
7/10/2022,Levy,Florida,12075,10779,167,10946
7/10/2022,Liberty,Florida,12077,2598,30,2628
7/10/2022,Madison,Florida,12079,6130,98,6228
7/10/2022,Manatee,Florida,12081,105335,1486,106821
7/10/2022,Marion,Florida,12083,89459,2149,91608
7/10/2022,Martin,Florida,12085,33795,637,34432
7/10/2022,Miami-Dade,Florida,12086,1336976,11168,1348144
7/10/2022,Monroe,Florida,12087,19895,120,20015
7/10/2022,Nassau,Florida,12089,23698,301,23999
7/10/2022,Okaloosa,Florida,12091,54581,700,55281
7/10/2022,Okeechobee,Florida,12093,11051,184,11235
7/10/2022,Orange,Florida,12095,417572,2898,420470
7/10/2022,Osceola,Florida,12097,125180,1165,126345
7/10/2022,Palm Beach,Florida,12099,411427,5216,416643
7/10/2022,Pasco,Florida,12101,135484,1966,137450
7/10/2022,Pinellas,Florida,12103,234561,3460,238021
7/10/2022,Polk,Florida,12105,220251,3051,223302
7/10/2022,Putnam,Florida,12107,18539,428,18967
7/10/2022,Santa Rosa,Florida,12113,51405,629,52034
7/10/2022,Sarasota,Florida,12115,101615,1688,103303
7/10/2022,Seminole,Florida,12117,114824,1122,115946
7/10/2022,St. Johns,Florida,12109,68109,579,68688
7/10/2022,St. Lucie,Florida,12111,81550,1255,82805
7/10/2022,Sumter,Florida,12119,24512,598,25110
7/10/2022,Suwannee,Florida,12121,13429,319,13748
7/10/2022,Taylor,Florida,12123,7259,101,7360
7/10/2022,Union,Florida,12125,4462,119,4581
7/10/2022,Unknown,Florida,,67860,302,68162
7/10/2022,Volusia,Florida,12127,128746,2034,130780
7/10/2022,Wakulla,Florida,12129,10501,130,10631
7/10/2022,Walton,Florida,12131,17374,215,17589
7/10/2022,Washington,Florida,12133,6889,113,7002
7/10/2022,Appling,Georgia,13001,4877,132,5009
7/10/2022,Atkinson,Georgia,13003,2242,51,2293
7/10/2022,Bacon,Georgia,13005,3815,78,3893
7/10/2022,Baker,Georgia,13007,555,15,570
7/10/2022,Baldwin,Georgia,13009,9858,241,10099
7/10/2022,Banks,Georgia,13011,4104,98,4202
7/10/2022,Barrow,Georgia,13013,22777,260,23037
7/10/2022,Bartow,Georgia,13015,30502,451,30953
7/10/2022,Ben Hill,Georgia,13017,4434,123,4557
7/10/2022,Berrien,Georgia,13019,5083,84,5167
7/10/2022,Bibb,Georgia,13021,39709,797,40506
7/10/2022,Bleckley,Georgia,13023,3478,100,3578
7/10/2022,Brantley,Georgia,13025,4268,111,4379
7/10/2022,Brooks,Georgia,13027,3532,87,3619
7/10/2022,Bryan,Georgia,13029,9677,93,9770
7/10/2022,Bulloch,Georgia,13031,15955,265,16220
7/10/2022,Burke,Georgia,13033,5476,113,5589
7/10/2022,Butts,Georgia,13035,6806,162,6968
7/10/2022,Calhoun,Georgia,13037,1399,24,1423
7/10/2022,Camden,Georgia,13039,12092,124,12216
7/10/2022,Candler,Georgia,13043,2279,100,2379
7/10/2022,Carroll,Georgia,13045,24738,466,25204
7/10/2022,Catoosa,Georgia,13047,15389,180,15569
7/10/2022,Charlton,Georgia,13049,3143,62,3205
7/10/2022,Chatham,Georgia,13051,68709,903,69612
7/10/2022,Chattahoochee,Georgia,13053,7539,22,7561
7/10/2022,Chattooga,Georgia,13055,6872,136,7008
7/10/2022,Cherokee,Georgia,13057,67078,644,67722
7/10/2022,Clarke,Georgia,13059,31210,237,31447
7/10/2022,Clay,Georgia,13061,545,6,551
7/10/2022,Clayton,Georgia,13063,68132,993,69125
7/10/2022,Clinch,Georgia,13065,2179,42,2221
7/10/2022,Cobb,Georgia,13067,189428,1875,191303
7/10/2022,Coffee,Georgia,13069,10892,281,11173
7/10/2022,Colquitt,Georgia,13071,12045,249,12294
7/10/2022,Columbia,Georgia,13073,37973,393,38366
7/10/2022,Cook,Georgia,13075,5073,75,5148
7/10/2022,Coweta,Georgia,13077,35309,497,35806
7/10/2022,Crawford,Georgia,13079,1852,55,1907
7/10/2022,Crisp,Georgia,13081,4845,137,4982
7/10/2022,Dade,Georgia,13083,3554,33,3587
7/10/2022,Dawson,Georgia,13085,7330,101,7431
7/10/2022,Decatur,Georgia,13087,7558,133,7691
7/10/2022,DeKalb,Georgia,13089,166093,1777,167870
7/10/2022,Dodge,Georgia,13091,5386,156,5542
7/10/2022,Dooly,Georgia,13093,2466,69,2535
7/10/2022,Dougherty,Georgia,13095,20883,508,21391
7/10/2022,Douglas,Georgia,13097,37247,410,37657
7/10/2022,Early,Georgia,13099,2872,64,2936
7/10/2022,Echols,Georgia,13101,952,12,964
7/10/2022,Effingham,Georgia,13103,14068,198,14266
7/10/2022,Elbert,Georgia,13105,4666,111,4777
7/10/2022,Emanuel,Georgia,13107,6086,160,6246
7/10/2022,Evans,Georgia,13109,2468,64,2532
7/10/2022,Fannin,Georgia,13111,5288,164,5452
7/10/2022,Fayette,Georgia,13113,24904,330,25234
7/10/2022,Floyd,Georgia,13115,28299,527,28826
7/10/2022,Forsyth,Georgia,13117,59617,410,60027
7/10/2022,Franklin,Georgia,13119,5541,104,5645
7/10/2022,Fulton,Georgia,13121,240444,2392,242836
7/10/2022,Gilmer,Georgia,13123,7224,180,7404
7/10/2022,Glascock,Georgia,13125,623,25,648
7/10/2022,Glynn,Georgia,13127,24381,410,24791
7/10/2022,Gordon,Georgia,13129,17470,272,17742
7/10/2022,Grady,Georgia,13131,6047,113,6160
7/10/2022,Greene,Georgia,13133,4134,85,4219
7/10/2022,Gwinnett,Georgia,13135,222955,1914,224869
7/10/2022,Habersham,Georgia,13137,10452,266,10718
7/10/2022,Hall,Georgia,13139,56635,858,57493
7/10/2022,Hancock,Georgia,13141,1647,90,1737
7/10/2022,Haralson,Georgia,13143,5611,178,5789
7/10/2022,Harris,Georgia,13145,6318,117,6435
7/10/2022,Hart,Georgia,13147,5003,104,5107
7/10/2022,Heard,Georgia,13149,2233,56,2289
7/10/2022,Henry,Georgia,13151,61855,695,62550
7/10/2022,Houston,Georgia,13153,42146,503,42649
7/10/2022,Irwin,Georgia,13155,1976,51,2027
7/10/2022,Jackson,Georgia,13157,21864,292,22156
7/10/2022,Jasper,Georgia,13159,3271,73,3344
7/10/2022,Jeff Davis,Georgia,13161,3995,74,4069
7/10/2022,Jefferson,Georgia,13163,3774,113,3887
7/10/2022,Jenkins,Georgia,13165,1565,68,1633
7/10/2022,Johnson,Georgia,13167,2298,73,2371
7/10/2022,Jones,Georgia,13169,5307,109,5416
7/10/2022,Lamar,Georgia,13171,5062,113,5175
7/10/2022,Lanier,Georgia,13173,2355,26,2381
7/10/2022,Laurens,Georgia,13175,14389,307,14696
7/10/2022,Lee,Georgia,13177,7739,104,7843
7/10/2022,Liberty,Georgia,13179,13076,153,13229
7/10/2022,Lincoln,Georgia,13181,1637,35,1672
7/10/2022,Long,Georgia,13183,2912,35,2947
7/10/2022,Lowndes,Georgia,13185,32431,395,32826
7/10/2022,Lumpkin,Georgia,13187,7585,132,7717
7/10/2022,Macon,Georgia,13193,2241,52,2293
7/10/2022,Madison,Georgia,13195,7143,113,7256
7/10/2022,Marion,Georgia,13197,1564,51,1615
7/10/2022,McDuffie,Georgia,13189,5285,103,5388
7/10/2022,McIntosh,Georgia,13191,2574,37,2611
7/10/2022,Meriwether,Georgia,13199,4691,147,4838
7/10/2022,Miller,Georgia,13201,1776,32,1808
7/10/2022,Mitchell,Georgia,13205,5462,119,5581
7/10/2022,Monroe,Georgia,13207,6214,174,6388
7/10/2022,Montgomery,Georgia,13209,2123,53,2176
7/10/2022,Morgan,Georgia,13211,4853,70,4923
7/10/2022,Murray,Georgia,13213,11861,191,12052
7/10/2022,Muscogee,Georgia,13215,40151,841,40992
7/10/2022,Newton,Georgia,13217,26070,462,26532
7/10/2022,Oconee,Georgia,13219,9222,107,9329
7/10/2022,Oglethorpe,Georgia,13221,3372,58,3430
7/10/2022,Paulding,Georgia,13223,40439,438,40877
7/10/2022,Peach,Georgia,13225,6624,138,6762
7/10/2022,Pickens,Georgia,13227,8758,170,8928
7/10/2022,Pierce,Georgia,13229,5846,130,5976
7/10/2022,Pike,Georgia,13231,5669,98,5767
7/10/2022,Polk,Georgia,13233,12243,196,12439
7/10/2022,Pulaski,Georgia,13235,2250,78,2328
7/10/2022,Putnam,Georgia,13237,4687,107,4794
7/10/2022,Quitman,Georgia,13239,445,4,449
7/10/2022,Rabun,Georgia,13241,3786,101,3887
7/10/2022,Randolph,Georgia,13243,1540,48,1588
7/10/2022,Richmond,Georgia,13245,52923,902,53825
7/10/2022,Rockdale,Georgia,13247,20055,329,20384
7/10/2022,Schley,Georgia,13249,1221,11,1232
7/10/2022,Screven,Georgia,13251,2775,70,2845
7/10/2022,Seminole,Georgia,13253,2234,30,2264
7/10/2022,Spalding,Georgia,13255,16776,424,17200
7/10/2022,Stephens,Georgia,13257,6503,163,6666
7/10/2022,Stewart,Georgia,13259,2814,35,2849
7/10/2022,Sumter,Georgia,13261,7135,171,7306
7/10/2022,Talbot,Georgia,13263,1207,33,1240
7/10/2022,Taliaferro,Georgia,13265,277,3,280
7/10/2022,Tattnall,Georgia,13267,5234,133,5367
7/10/2022,Taylor,Georgia,13269,2056,54,2110
7/10/2022,Telfair,Georgia,13271,3168,87,3255
7/10/2022,Terrell,Georgia,13273,2151,68,2219
7/10/2022,Thomas,Georgia,13275,12465,213,12678
7/10/2022,Tift,Georgia,13277,12011,222,12233
7/10/2022,Toombs,Georgia,13279,7295,205,7500
7/10/2022,Towns,Georgia,13281,2495,117,2612
7/10/2022,Treutlen,Georgia,13283,1697,62,1759
7/10/2022,Troup,Georgia,13285,16083,384,16467
7/10/2022,Turner,Georgia,13287,2657,62,2719
7/10/2022,Twiggs,Georgia,13289,1595,70,1665
7/10/2022,Union,Georgia,13291,5200,159,5359
7/10/2022,Unknown,Georgia,,11916,5,11921
7/10/2022,Upson,Georgia,13293,8088,239,8327
7/10/2022,Walker,Georgia,13295,17825,254,18079
7/10/2022,Walton,Georgia,13297,22893,433,23326
7/10/2022,Ware,Georgia,13299,10416,284,10700
7/10/2022,Warren,Georgia,13301,1103,30,1133
7/10/2022,Washington,Georgia,13303,4593,137,4730
7/10/2022,Wayne,Georgia,13305,8001,205,8206
7/10/2022,Webster,Georgia,13307,452,8,460
7/10/2022,Wheeler,Georgia,13309,1459,39,1498
7/10/2022,White,Georgia,13311,7126,167,7293
7/10/2022,Whitfield,Georgia,13313,34802,441,35243
7/10/2022,Wilcox,Georgia,13315,2058,71,2129
7/10/2022,Wilkes,Georgia,13317,2306,53,2359
7/10/2022,Wilkinson,Georgia,13319,2353,59,2412
7/10/2022,Worth,Georgia,13321,4860,120,4980
7/10/2022,Unknown,Guam,,53613,372,53985
7/10/2022,Hawaii,Hawaii,15001,34660,198,34858
7/10/2022,Honolulu,Hawaii,15003,217248,1135,218383
7/10/2022,Kalawao,Hawaii,15005,1,0,1
7/10/2022,Kauai,Hawaii,15007,15867,34,15901
7/10/2022,Maui,Hawaii,15009,37572,145,37717
7/10/2022,Unknown,Hawaii,,0,9,9
7/10/2022,Ada,Idaho,16001,143470,1033,144503
7/10/2022,Adams,Idaho,16003,738,15,753
7/10/2022,Bannock,Idaho,16005,21810,251,22061
7/10/2022,Bear Lake,Idaho,16007,992,16,1008
7/10/2022,Benewah,Idaho,16009,2509,41,2550
7/10/2022,Bingham,Idaho,16011,10163,161,10324
7/10/2022,Blaine,Idaho,16013,6451,30,6481
7/10/2022,Boise,Idaho,16015,1159,14,1173
7/10/2022,Bonner,Idaho,16017,9320,190,9510
7/10/2022,Bonneville,Idaho,16019,31951,289,32240
7/10/2022,Boundary,Idaho,16021,2183,63,2246
7/10/2022,Butte,Idaho,16023,494,10,504
7/10/2022,Camas,Idaho,16025,164,2,166
7/10/2022,Canyon,Idaho,16027,63652,690,64342
7/10/2022,Caribou,Idaho,16029,1524,28,1552
7/10/2022,Cassia,Idaho,16031,5103,53,5156
7/10/2022,Clark,Idaho,16033,113,1,114
7/10/2022,Clearwater,Idaho,16035,2388,33,2421
7/10/2022,Custer,Idaho,16037,604,9,613
7/10/2022,Elmore,Idaho,16039,7764,70,7834
7/10/2022,Franklin,Idaho,16041,2416,29,2445
7/10/2022,Fremont,Idaho,16043,2246,28,2274
7/10/2022,Gem,Idaho,16045,3805,80,3885
7/10/2022,Gooding,Idaho,16047,3409,55,3464
7/10/2022,Idaho,Idaho,16049,3163,52,3215
7/10/2022,Jefferson,Idaho,16051,6205,65,6270
7/10/2022,Jerome,Idaho,16053,6299,65,6364
7/10/2022,Kootenai,Idaho,16055,43566,604,44170
7/10/2022,Latah,Idaho,16057,7117,51,7168
7/10/2022,Lemhi,Idaho,16059,1367,26,1393
7/10/2022,Lewis,Idaho,16061,1191,29,1220
7/10/2022,Lincoln,Idaho,16063,1135,15,1150
7/10/2022,Madison,Idaho,16065,13059,54,13113
7/10/2022,Minidoka,Idaho,16067,4331,65,4396
7/10/2022,Nez Perce,Idaho,16069,9372,150,9522
7/10/2022,Oneida,Idaho,16071,844,11,855
7/10/2022,Owyhee,Idaho,16073,2346,53,2399
7/10/2022,Payette,Idaho,16075,5790,87,5877
7/10/2022,Power,Idaho,16077,1528,20,1548
7/10/2022,Shoshone,Idaho,16079,2845,77,2922
7/10/2022,Teton,Idaho,16081,2804,9,2813
7/10/2022,Twin Falls,Idaho,16083,25224,298,25522
7/10/2022,Valley,Idaho,16085,2809,16,2825
7/10/2022,Washington,Idaho,16087,2464,57,2521
7/10/2022,Adams,Illinois,17001,23904,239,24143
7/10/2022,Alexander,Illinois,17003,1363,15,1378
7/10/2022,Bond,Illinois,17005,4607,37,4644
7/10/2022,Boone,Illinois,17007,15084,132,15216
7/10/2022,Brown,Illinois,17009,2526,21,2547
7/10/2022,Bureau,Illinois,17011,8856,141,8997
7/10/2022,Calhoun,Illinois,17013,1594,8,1602
7/10/2022,Carroll,Illinois,17015,4494,50,4544
7/10/2022,Cass,Illinois,17017,4875,44,4919
7/10/2022,Champaign,Illinois,17019,72164,299,72463
7/10/2022,Christian,Illinois,17021,10897,131,11028
7/10/2022,Clark,Illinois,17023,5103,60,5163
7/10/2022,Clay,Illinois,17025,4953,74,5027
7/10/2022,Clinton,Illinois,17027,12612,122,12734
7/10/2022,Coles,Illinois,17029,16127,176,16303
7/10/2022,Cook,Illinois,17031,1298231,15101,1313332
7/10/2022,Crawford,Illinois,17033,6556,61,6617
7/10/2022,Cumberland,Illinois,17035,3470,49,3519
7/10/2022,DeKalb,Illinois,17037,26719,206,26925
7/10/2022,De Witt,Illinois,17039,4685,47,4732
7/10/2022,Douglas,Illinois,17041,6900,61,6961
7/10/2022,DuPage,Illinois,17043,244998,1831,246829
7/10/2022,Edgar,Illinois,17045,5509,80,5589
7/10/2022,Edwards,Illinois,17047,1823,29,1852
7/10/2022,Effingham,Illinois,17049,11155,150,11305
7/10/2022,Fayette,Illinois,17051,7432,104,7536
7/10/2022,Ford,Illinois,17053,4746,77,4823
7/10/2022,Franklin,Illinois,17055,12868,180,13048
7/10/2022,Fulton,Illinois,17057,11033,139,11172
7/10/2022,Gallatin,Illinois,17059,1491,19,1510
7/10/2022,Greene,Illinois,17061,3782,59,3841
7/10/2022,Grundy,Illinois,17063,13791,144,13935
7/10/2022,Hamilton,Illinois,17065,2265,34,2299
7/10/2022,Hancock,Illinois,17067,4627,58,4685
7/10/2022,Hardin,Illinois,17069,1092,20,1112
7/10/2022,Henderson,Illinois,17071,1246,28,1274
7/10/2022,Henry,Illinois,17073,13582,150,13732
7/10/2022,Iroquois,Illinois,17075,7684,120,7804
7/10/2022,Jackson,Illinois,17077,17099,135,17234
7/10/2022,Jasper,Illinois,17079,2770,33,2803
7/10/2022,Jefferson,Illinois,17081,11569,177,11746
7/10/2022,Jersey,Illinois,17083,6657,92,6749
7/10/2022,Jo Daviess,Illinois,17085,4389,40,4429
7/10/2022,Johnson,Illinois,17087,4736,47,4783
7/10/2022,Kane,Illinois,17089,141174,1196,142370
7/10/2022,Kankakee,Illinois,17091,31252,381,31633
7/10/2022,Kendall,Illinois,17093,35461,173,35634
7/10/2022,Knox,Illinois,17095,13733,249,13982
7/10/2022,Lake,Illinois,17097,174915,1494,176409
7/10/2022,LaSalle,Illinois,17099,31725,448,32173
7/10/2022,Lawrence,Illinois,17101,5691,52,5743
7/10/2022,Lee,Illinois,17103,9701,119,9820
7/10/2022,Livingston,Illinois,17105,11530,148,11678
7/10/2022,Logan,Illinois,17107,10703,105,10808
7/10/2022,Macon,Illinois,17115,33472,361,33833
7/10/2022,Macoupin,Illinois,17117,13685,171,13856
7/10/2022,Madison,Illinois,17119,76461,875,77336
7/10/2022,Marion,Illinois,17121,12474,217,12691
7/10/2022,Marshall,Illinois,17123,2991,33,3024
7/10/2022,Mason,Illinois,17125,4226,63,4289
7/10/2022,Massac,Illinois,17127,4082,74,4156
7/10/2022,McDonough,Illinois,17109,7679,109,7788
7/10/2022,McHenry,Illinois,17111,84392,517,84909
7/10/2022,McLean,Illinois,17113,56465,338,56803
7/10/2022,Menard,Illinois,17129,3859,26,3885
7/10/2022,Mercer,Illinois,17131,4318,49,4367
7/10/2022,Monroe,Illinois,17133,10105,130,10235
7/10/2022,Montgomery,Illinois,17135,10312,111,10423
7/10/2022,Morgan,Illinois,17137,10397,146,10543
7/10/2022,Moultrie,Illinois,17139,4264,54,4318
7/10/2022,Ogle,Illinois,17141,15074,136,15210
7/10/2022,Peoria,Illinois,17143,52317,555,52872
7/10/2022,Perry,Illinois,17145,7768,106,7874
7/10/2022,Piatt,Illinois,17147,4834,29,4863
7/10/2022,Pike,Illinois,17149,5270,71,5341
7/10/2022,Pope,Illinois,17151,1003,9,1012
7/10/2022,Pulaski,Illinois,17153,1793,21,1814
7/10/2022,Putnam,Illinois,17155,1218,10,1228
7/10/2022,Randolph,Illinois,17157,11035,136,11171
7/10/2022,Richland,Illinois,17159,5369,83,5452
7/10/2022,Rock Island,Illinois,17161,36034,529,36563
7/10/2022,Saline,Illinois,17165,8349,113,8462
7/10/2022,Sangamon,Illinois,17167,63152,446,63598
7/10/2022,Schuyler,Illinois,17169,2130,29,2159
7/10/2022,Scott,Illinois,17171,1342,12,1354
7/10/2022,Shelby,Illinois,17173,6487,80,6567
7/10/2022,Stark,Illinois,17175,1633,37,1670
7/10/2022,St. Clair,Illinois,17163,75870,787,76657
7/10/2022,Stephenson,Illinois,17177,12555,186,12741
7/10/2022,Tazewell,Illinois,17179,40545,515,41060
7/10/2022,Union,Illinois,17181,5748,70,5818
7/10/2022,Unknown,Illinois,,0,2445,2445
7/10/2022,Vermilion,Illinois,17183,29935,314,30249
7/10/2022,Wabash,Illinois,17185,3917,31,3948
7/10/2022,Warren,Illinois,17187,4311,89,4400
7/10/2022,Washington,Illinois,17189,3586,42,3628
7/10/2022,Wayne,Illinois,17191,5578,85,5663
7/10/2022,White,Illinois,17193,4560,59,4619
7/10/2022,Whiteside,Illinois,17195,16690,272,16962
7/10/2022,Will,Illinois,17197,183385,1645,185030
7/10/2022,Williamson,Illinois,17199,24248,266,24514
7/10/2022,Winnebago,Illinois,17201,84856,868,85724
7/10/2022,Woodford,Illinois,17203,11218,125,11343
7/10/2022,Adams,Indiana,18001,7530,114,7644
7/10/2022,Allen,Indiana,18003,108415,1201,109616
7/10/2022,Bartholomew,Indiana,18005,22653,251,22904
7/10/2022,Benton,Indiana,18007,2579,22,2601
7/10/2022,Blackford,Indiana,18009,3255,69,3324
7/10/2022,Boone,Indiana,18011,16155,191,16346
7/10/2022,Brown,Indiana,18013,2710,62,2772
7/10/2022,Carroll,Indiana,18015,4382,70,4452
7/10/2022,Cass,Indiana,18017,12066,168,12234
7/10/2022,Clark,Indiana,18019,33900,402,34302
7/10/2022,Clay,Indiana,18021,7170,92,7262
7/10/2022,Clinton,Indiana,18023,9556,132,9688
7/10/2022,Crawford,Indiana,18025,2649,40,2689
7/10/2022,Daviess,Indiana,18027,7669,155,7824
7/10/2022,Dearborn,Indiana,18029,14075,142,14217
7/10/2022,Decatur,Indiana,18031,7280,148,7428
7/10/2022,DeKalb,Indiana,18033,11751,153,11904
7/10/2022,Delaware,Indiana,18035,26243,449,26692
7/10/2022,Dubois,Indiana,18037,13196,165,13361
7/10/2022,Elkhart,Indiana,18039,55651,741,56392
7/10/2022,Fayette,Indiana,18041,6984,147,7131
7/10/2022,Floyd,Indiana,18043,20486,307,20793
7/10/2022,Fountain,Indiana,18045,5689,105,5794
7/10/2022,Franklin,Indiana,18047,4489,66,4555
7/10/2022,Fulton,Indiana,18049,5046,103,5149
7/10/2022,Gibson,Indiana,18051,12248,148,12396
7/10/2022,Grant,Indiana,18053,17988,359,18347
7/10/2022,Greene,Indiana,18055,7641,142,7783
7/10/2022,Hamilton,Indiana,18057,87679,673,88352
7/10/2022,Hancock,Indiana,18059,21787,264,22051
7/10/2022,Harrison,Indiana,18061,11412,140,11552
7/10/2022,Hendricks,Indiana,18063,42790,558,43348
7/10/2022,Henry,Indiana,18065,13679,234,13913
7/10/2022,Howard,Indiana,18067,26353,454,26807
7/10/2022,Huntington,Indiana,18069,12020,158,12178
7/10/2022,Jackson,Indiana,18071,13030,134,13164
7/10/2022,Jasper,Indiana,18073,9555,150,9705
7/10/2022,Jay,Indiana,18075,4993,78,5071
7/10/2022,Jefferson,Indiana,18077,9626,163,9789
7/10/2022,Jennings,Indiana,18079,7154,110,7264
7/10/2022,Johnson,Indiana,18081,44525,620,45145
7/10/2022,Knox,Indiana,18083,11374,153,11527
7/10/2022,Kosciusko,Indiana,18085,20400,238,20638
7/10/2022,LaGrange,Indiana,18087,5958,103,6061
7/10/2022,Lake,Indiana,18089,115083,1854,116937
7/10/2022,LaPorte,Indiana,18091,27437,374,27811
7/10/2022,Lawrence,Indiana,18093,12677,265,12942
7/10/2022,Madison,Indiana,18095,34219,658,34877
7/10/2022,Marion,Indiana,18097,237349,3021,240370
7/10/2022,Marshall,Indiana,18099,12718,197,12915
7/10/2022,Martin,Indiana,18101,2231,25,2256
7/10/2022,Miami,Indiana,18103,9516,162,9678
7/10/2022,Monroe,Indiana,18105,30521,285,30806
7/10/2022,Montgomery,Indiana,18107,11063,165,11228
7/10/2022,Morgan,Indiana,18109,17268,290,17558
7/10/2022,Newton,Indiana,18111,2720,68,2788
7/10/2022,Noble,Indiana,18113,13589,161,13750
7/10/2022,Ohio,Indiana,18115,1501,19,1520
7/10/2022,Orange,Indiana,18117,5252,99,5351
7/10/2022,Owen,Indiana,18119,6166,123,6289
7/10/2022,Parke,Indiana,18121,3722,47,3769
7/10/2022,Perry,Indiana,18123,4836,69,4905
7/10/2022,Pike,Indiana,18125,3887,50,3937
7/10/2022,Porter,Indiana,18127,40997,575,41572
7/10/2022,Posey,Indiana,18129,6802,58,6860
7/10/2022,Pulaski,Indiana,18131,3151,86,3237
7/10/2022,Putnam,Indiana,18133,9716,130,9846
7/10/2022,Randolph,Indiana,18135,6072,148,6220
7/10/2022,Ripley,Indiana,18137,8605,139,8744
7/10/2022,Rush,Indiana,18139,5053,58,5111
7/10/2022,Scott,Indiana,18143,8190,108,8298
7/10/2022,Shelby,Indiana,18145,14320,184,14504
7/10/2022,Spencer,Indiana,18147,5405,61,5466
7/10/2022,Starke,Indiana,18149,4943,100,5043
7/10/2022,Steuben,Indiana,18151,9988,122,10110
7/10/2022,St. Joseph,Indiana,18141,74976,885,75861
7/10/2022,Sullivan,Indiana,18153,5464,77,5541
7/10/2022,Switzerland,Indiana,18155,2344,20,2364
7/10/2022,Tippecanoe,Indiana,18157,54179,412,54591
7/10/2022,Tipton,Indiana,18159,3631,88,3719
7/10/2022,Union,Indiana,18161,2087,22,2109
7/10/2022,Unknown,Indiana,,0,12,12
7/10/2022,Vanderburgh,Indiana,18163,60530,642,61172
7/10/2022,Vermillion,Indiana,18165,4317,77,4394
7/10/2022,Vigo,Indiana,18167,30282,416,30698
7/10/2022,Wabash,Indiana,18169,9019,160,9179
7/10/2022,Warren,Indiana,18171,2157,30,2187
7/10/2022,Warrick,Indiana,18173,21435,240,21675
7/10/2022,Washington,Indiana,18175,6196,87,6283
7/10/2022,Wayne,Indiana,18177,19767,340,20107
7/10/2022,Wells,Indiana,18179,6673,134,6807
7/10/2022,White,Indiana,18181,7181,97,7278
7/10/2022,Whitley,Indiana,18183,10033,85,10118
7/10/2022,Adair,Iowa,19001,1620,51,1671
7/10/2022,Adams,Iowa,19003,837,14,851
7/10/2022,Allamakee,Iowa,19005,2951,60,3011
7/10/2022,Appanoose,Iowa,19007,2987,70,3057
7/10/2022,Audubon,Iowa,19009,1142,21,1163
7/10/2022,Benton,Iowa,19011,6345,79,6424
7/10/2022,Black Hawk,Iowa,19013,34418,491,34909
7/10/2022,Boone,Iowa,19015,5782,57,5839
7/10/2022,Bremer,Iowa,19017,5772,83,5855
7/10/2022,Buchanan,Iowa,19019,4815,60,4875
7/10/2022,Buena Vista,Iowa,19021,6467,58,6525
7/10/2022,Butler,Iowa,19023,3377,54,3431
7/10/2022,Calhoun,Iowa,19025,2712,25,2737
7/10/2022,Carroll,Iowa,19027,5133,66,5199
7/10/2022,Cass,Iowa,19029,3005,78,3083
7/10/2022,Cedar,Iowa,19031,4390,36,4426
7/10/2022,Cerro Gordo,Iowa,19033,11527,171,11698
7/10/2022,Cherokee,Iowa,19035,3066,65,3131
7/10/2022,Chickasaw,Iowa,19037,2799,32,2831
7/10/2022,Clarke,Iowa,19039,2342,37,2379
7/10/2022,Clay,Iowa,19041,4236,45,4281
7/10/2022,Clayton,Iowa,19043,3621,74,3695
7/10/2022,Clinton,Iowa,19045,12010,146,12156
7/10/2022,Crawford,Iowa,19047,4553,54,4607
7/10/2022,Dallas,Iowa,19049,24380,148,24528
7/10/2022,Davis,Iowa,19051,1664,33,1697
7/10/2022,Decatur,Iowa,19053,1581,26,1607
7/10/2022,Delaware,Iowa,19055,4196,68,4264
7/10/2022,Des Moines,Iowa,19057,9586,142,9728
7/10/2022,Dickinson,Iowa,19059,4252,73,4325
7/10/2022,Dubuque,Iowa,19061,27585,299,27884
7/10/2022,Emmet,Iowa,19063,2415,54,2469
7/10/2022,Fayette,Iowa,19065,4270,76,4346
7/10/2022,Floyd,Iowa,19067,3749,62,3811
7/10/2022,Franklin,Iowa,19069,2607,43,2650
7/10/2022,Fremont,Iowa,19071,1433,26,1459
7/10/2022,Greene,Iowa,19073,1802,21,1823
7/10/2022,Grundy,Iowa,19075,2650,44,2694
7/10/2022,Guthrie,Iowa,19077,2445,47,2492
7/10/2022,Hamilton,Iowa,19079,3586,73,3659
7/10/2022,Hancock,Iowa,19081,2970,48,3018
7/10/2022,Hardin,Iowa,19083,4313,63,4376
7/10/2022,Harrison,Iowa,19085,3513,95,3608
7/10/2022,Henry,Iowa,19087,5754,76,5830
7/10/2022,Howard,Iowa,19089,2117,35,2152
7/10/2022,Humboldt,Iowa,19091,2718,38,2756
7/10/2022,Ida,Iowa,19093,1855,49,1904
7/10/2022,Iowa,Iowa,19095,3865,50,3915
7/10/2022,Jackson,Iowa,19097,4853,70,4923
7/10/2022,Jasper,Iowa,19099,9116,112,9228
7/10/2022,Jefferson,Iowa,19101,3675,52,3727
7/10/2022,Johnson,Iowa,19103,38688,155,38843
7/10/2022,Jones,Iowa,19105,5731,74,5805
7/10/2022,Keokuk,Iowa,19107,2133,48,2181
7/10/2022,Kossuth,Iowa,19109,3899,88,3987
7/10/2022,Lee,Iowa,19111,8080,142,8222
7/10/2022,Linn,Iowa,19113,56020,595,56615
7/10/2022,Louisa,Iowa,19115,2591,63,2654
7/10/2022,Lucas,Iowa,19117,1835,32,1867
7/10/2022,Lyon,Iowa,19119,2815,51,2866
7/10/2022,Madison,Iowa,19121,3264,40,3304
7/10/2022,Mahaska,Iowa,19123,5112,89,5201
7/10/2022,Marion,Iowa,19125,7881,127,8008
7/10/2022,Marshall,Iowa,19127,9885,113,9998
7/10/2022,Mills,Iowa,19129,3512,44,3556
7/10/2022,Mitchell,Iowa,19131,2581,49,2630
7/10/2022,Monona,Iowa,19133,1772,49,1821
7/10/2022,Monroe,Iowa,19135,1945,49,1994
7/10/2022,Montgomery,Iowa,19137,2274,56,2330
7/10/2022,Muscatine,Iowa,19139,10095,132,10227
7/10/2022,O'Brien,Iowa,19141,3532,71,3603
7/10/2022,Osceola,Iowa,19143,1416,22,1438
7/10/2022,Page,Iowa,19145,3407,49,3456
7/10/2022,Palo Alto,Iowa,19147,2106,38,2144
7/10/2022,Plymouth,Iowa,19149,6449,103,6552
7/10/2022,Pocahontas,Iowa,19151,1677,27,1704
7/10/2022,Polk,Iowa,19153,132457,1116,133573
7/10/2022,Pottawattamie,Iowa,19155,25101,321,25422
7/10/2022,Poweshiek,Iowa,19157,3952,63,4015
7/10/2022,Ringgold,Iowa,19159,1154,34,1188
7/10/2022,Sac,Iowa,19161,2479,36,2515
7/10/2022,Scott,Iowa,19163,43468,402,43870
7/10/2022,Shelby,Iowa,19165,2800,52,2852
7/10/2022,Sioux,Iowa,19167,8152,89,8241
7/10/2022,Story,Iowa,19169,20862,92,20954
7/10/2022,Tama,Iowa,19171,4077,95,4172
7/10/2022,Taylor,Iowa,19173,1343,22,1365
7/10/2022,Union,Iowa,19175,2803,52,2855
7/10/2022,Unknown,Iowa,,475,0,475
7/10/2022,Van Buren,Iowa,19177,1437,27,1464
7/10/2022,Wapello,Iowa,19179,9325,208,9533
7/10/2022,Warren,Iowa,19181,13089,136,13225
7/10/2022,Washington,Iowa,19183,5876,79,5955
7/10/2022,Wayne,Iowa,19185,1315,33,1348
7/10/2022,Webster,Iowa,19187,10761,166,10927
7/10/2022,Winnebago,Iowa,19189,3086,47,3133
7/10/2022,Winneshiek,Iowa,19191,4063,52,4115
7/10/2022,Woodbury,Iowa,19193,29482,342,29824
7/10/2022,Worth,Iowa,19195,1827,17,1844
7/10/2022,Wright,Iowa,19197,3707,66,3773
7/10/2022,Allen,Kansas,20001,4184,58,4242
7/10/2022,Anderson,Kansas,20003,2223,35,2258
7/10/2022,Atchison,Kansas,20005,4495,38,4533
7/10/2022,Barber,Kansas,20007,1058,9,1067
7/10/2022,Barton,Kansas,20009,6652,107,6759
7/10/2022,Bourbon,Kansas,20011,4634,56,4690
7/10/2022,Brown,Kansas,20013,2813,49,2862
7/10/2022,Butler,Kansas,20015,19736,200,19936
7/10/2022,Chase,Kansas,20017,689,7,696
7/10/2022,Chautauqua,Kansas,20019,867,18,885
7/10/2022,Cherokee,Kansas,20021,6395,89,6484
7/10/2022,Cheyenne,Kansas,20023,663,14,677
7/10/2022,Clark,Kansas,20025,512,8,520
7/10/2022,Clay,Kansas,20027,2049,38,2087
7/10/2022,Cloud,Kansas,20029,2285,42,2327
7/10/2022,Coffey,Kansas,20031,2488,45,2533
7/10/2022,Comanche,Kansas,20033,451,17,468
7/10/2022,Cowley,Kansas,20035,10478,163,10641
7/10/2022,Crawford,Kansas,20037,12555,134,12689
7/10/2022,Decatur,Kansas,20039,637,20,657
7/10/2022,Dickinson,Kansas,20041,4988,86,5074
7/10/2022,Doniphan,Kansas,20043,2511,34,2545
7/10/2022,Douglas,Kansas,20045,29384,143,29527
7/10/2022,Edwards,Kansas,20047,565,13,578
7/10/2022,Elk,Kansas,20049,584,12,596
7/10/2022,Ellis,Kansas,20051,7348,87,7435
7/10/2022,Ellsworth,Kansas,20053,2047,31,2078
7/10/2022,Finney,Kansas,20055,11829,118,11947
7/10/2022,Ford,Kansas,20057,10921,118,11039
7/10/2022,Franklin,Kansas,20059,7227,93,7320
7/10/2022,Geary,Kansas,20061,9599,78,9677
7/10/2022,Gove,Kansas,20063,821,23,844
7/10/2022,Graham,Kansas,20065,590,15,605
7/10/2022,Grant,Kansas,20067,2313,37,2350
7/10/2022,Gray,Kansas,20069,1247,23,1270
7/10/2022,Greeley,Kansas,20071,336,3,339
7/10/2022,Greenwood,Kansas,20073,1849,26,1875
7/10/2022,Hamilton,Kansas,20075,468,3,471
7/10/2022,Harper,Kansas,20077,1691,28,1719
7/10/2022,Harvey,Kansas,20079,10012,126,10138
7/10/2022,Haskell,Kansas,20081,978,12,990
7/10/2022,Hodgeman,Kansas,20083,422,11,433
7/10/2022,Jackson,Kansas,20085,4029,31,4060
7/10/2022,Jefferson,Kansas,20087,5008,67,5075
7/10/2022,Jewell,Kansas,20089,809,15,824
7/10/2022,Johnson,Kansas,20091,157609,1248,158857
7/10/2022,Kearny,Kansas,20093,1269,22,1291
7/10/2022,Kingman,Kansas,20095,2038,28,2066
7/10/2022,Kiowa,Kansas,20097,691,7,698
7/10/2022,Labette,Kansas,20099,6875,80,6955
7/10/2022,Lane,Kansas,20101,302,12,314
7/10/2022,Leavenworth,Kansas,20103,20601,199,20800
7/10/2022,Lincoln,Kansas,20105,640,11,651
7/10/2022,Linn,Kansas,20107,2927,32,2959
7/10/2022,Logan,Kansas,20109,880,13,893
7/10/2022,Lyon,Kansas,20111,10488,125,10613
7/10/2022,Marion,Kansas,20115,3433,46,3479
7/10/2022,Marshall,Kansas,20117,2607,44,2651
7/10/2022,McPherson,Kansas,20113,8104,130,8234
7/10/2022,Meade,Kansas,20119,1240,22,1262
7/10/2022,Miami,Kansas,20121,8281,100,8381
7/10/2022,Mitchell,Kansas,20123,1467,24,1491
7/10/2022,Montgomery,Kansas,20125,9686,166,9852
7/10/2022,Morris,Kansas,20127,1549,30,1579
7/10/2022,Morton,Kansas,20129,639,12,651
7/10/2022,Nemaha,Kansas,20131,3327,60,3387
7/10/2022,Neosho,Kansas,20133,5387,69,5456
7/10/2022,Ness,Kansas,20135,796,19,815
7/10/2022,Norton,Kansas,20137,2164,36,2200
7/10/2022,Osage,Kansas,20139,4092,61,4153
7/10/2022,Osborne,Kansas,20141,829,19,848
7/10/2022,Ottawa,Kansas,20143,1236,23,1259
7/10/2022,Pawnee,Kansas,20145,2236,24,2260
7/10/2022,Phillips,Kansas,20147,1383,30,1413
7/10/2022,Pottawatomie,Kansas,20149,6024,60,6084
7/10/2022,Pratt,Kansas,20151,1992,34,2026
7/10/2022,Rawlins,Kansas,20153,696,9,705
7/10/2022,Reno,Kansas,20155,19325,245,19570
7/10/2022,Republic,Kansas,20157,1368,19,1387
7/10/2022,Rice,Kansas,20159,2694,27,2721
7/10/2022,Riley,Kansas,20161,14170,88,14258
7/10/2022,Rooks,Kansas,20163,1405,21,1426
7/10/2022,Rush,Kansas,20165,820,19,839
7/10/2022,Russell,Kansas,20167,1905,39,1944
7/10/2022,Saline,Kansas,20169,14625,253,14878
7/10/2022,Scott,Kansas,20171,1336,34,1370
7/10/2022,Sedgwick,Kansas,20173,150135,1477,151612
7/10/2022,Seward,Kansas,20175,7067,63,7130
7/10/2022,Shawnee,Kansas,20177,51168,650,51818
7/10/2022,Sheridan,Kansas,20179,802,18,820
7/10/2022,Sherman,Kansas,20181,1540,22,1562
7/10/2022,Smith,Kansas,20183,649,9,658
7/10/2022,Stafford,Kansas,20185,1178,28,1206
7/10/2022,Stanton,Kansas,20187,437,9,446
7/10/2022,Stevens,Kansas,20189,1585,22,1607
7/10/2022,Sumner,Kansas,20191,5852,75,5927
7/10/2022,Thomas,Kansas,20193,2528,29,2557
7/10/2022,Trego,Kansas,20195,796,12,808
7/10/2022,Wabaunsee,Kansas,20197,1698,23,1721
7/10/2022,Wallace,Kansas,20199,444,7,451
7/10/2022,Washington,Kansas,20201,1436,23,1459
7/10/2022,Wichita,Kansas,20203,540,8,548
7/10/2022,Wilson,Kansas,20205,2901,50,2951
7/10/2022,Woodson,Kansas,20207,833,17,850
7/10/2022,Wyandotte,Kansas,20209,48906,521,49427
7/10/2022,Adair,Kentucky,21001,6228,107,6335
7/10/2022,Allen,Kentucky,21003,6890,108,6998
7/10/2022,Anderson,Kentucky,21005,6974,71,7045
7/10/2022,Ballard,Kentucky,21007,1529,32,1561
7/10/2022,Barren,Kentucky,21009,13603,222,13825
7/10/2022,Bath,Kentucky,21011,3397,49,3446
7/10/2022,Bell,Kentucky,21013,9076,159,9235
7/10/2022,Boone,Kentucky,21015,41391,305,41696
7/10/2022,Bourbon,Kentucky,21017,6366,61,6427
7/10/2022,Boyd,Kentucky,21019,17463,181,17644
7/10/2022,Boyle,Kentucky,21021,9319,136,9455
7/10/2022,Bracken,Kentucky,21023,2316,27,2343
7/10/2022,Breathitt,Kentucky,21025,4090,54,4144
7/10/2022,Breckinridge,Kentucky,21027,5352,80,5432
7/10/2022,Bullitt,Kentucky,21029,23419,229,23648
7/10/2022,Butler,Kentucky,21031,4003,55,4058
7/10/2022,Caldwell,Kentucky,21033,4331,62,4393
7/10/2022,Calloway,Kentucky,21035,9470,97,9567
7/10/2022,Campbell,Kentucky,21037,26078,186,26264
7/10/2022,Carlisle,Kentucky,21039,1141,20,1161
7/10/2022,Carroll,Kentucky,21041,3603,48,3651
7/10/2022,Carter,Kentucky,21043,9221,109,9330
7/10/2022,Casey,Kentucky,21045,4336,76,4412
7/10/2022,Christian,Kentucky,21047,17112,214,17326
7/10/2022,Clark,Kentucky,21049,11503,73,11576
7/10/2022,Clay,Kentucky,21051,8018,96,8114
7/10/2022,Clinton,Kentucky,21053,3843,53,3896
7/10/2022,Crittenden,Kentucky,21055,2416,51,2467
7/10/2022,Cumberland,Kentucky,21057,2292,33,2325
7/10/2022,Daviess,Kentucky,21059,32344,395,32739
7/10/2022,Edmonson,Kentucky,21061,2683,50,2733
7/10/2022,Elliott,Kentucky,21063,2777,20,2797
7/10/2022,Estill,Kentucky,21065,4238,52,4290
7/10/2022,Fayette,Kentucky,21067,102882,627,103509
7/10/2022,Fleming,Kentucky,21069,4172,62,4234
7/10/2022,Floyd,Kentucky,21071,13030,221,13251
7/10/2022,Franklin,Kentucky,21073,14840,159,14999
7/10/2022,Fulton,Kentucky,21075,1266,33,1299
7/10/2022,Gallatin,Kentucky,21077,2281,51,2332
7/10/2022,Garrard,Kentucky,21079,5012,80,5092
7/10/2022,Grant,Kentucky,21081,8169,67,8236
7/10/2022,Graves,Kentucky,21083,11871,184,12055
7/10/2022,Grayson,Kentucky,21085,8325,135,8460
7/10/2022,Green,Kentucky,21087,3886,45,3931
7/10/2022,Greenup,Kentucky,21089,12891,149,13040
7/10/2022,Hancock,Kentucky,21091,2603,25,2628
7/10/2022,Hardin,Kentucky,21093,34964,446,35410
7/10/2022,Harlan,Kentucky,21095,9516,216,9732
7/10/2022,Harrison,Kentucky,21097,6966,79,7045
7/10/2022,Hart,Kentucky,21099,5637,104,5741
7/10/2022,Henderson,Kentucky,21101,14474,173,14647
7/10/2022,Henry,Kentucky,21103,5260,53,5313
7/10/2022,Hickman,Kentucky,21105,927,28,955
7/10/2022,Hopkins,Kentucky,21107,15558,258,15816
7/10/2022,Jackson,Kentucky,21109,4398,82,4480
7/10/2022,Jefferson,Kentucky,21111,254443,2421,256864
7/10/2022,Jessamine,Kentucky,21113,16089,146,16235
7/10/2022,Johnson,Kentucky,21115,6819,124,6943
7/10/2022,Kenton,Kentucky,21117,47789,434,48223
7/10/2022,Knott,Kentucky,21119,4452,66,4518
7/10/2022,Knox,Kentucky,21121,11984,151,12135
7/10/2022,Larue,Kentucky,21123,3925,74,3999
7/10/2022,Laurel,Kentucky,21125,21248,250,21498
7/10/2022,Lawrence,Kentucky,21127,4715,72,4787
7/10/2022,Lee,Kentucky,21129,2986,55,3041
7/10/2022,Leslie,Kentucky,21131,3904,49,3953
7/10/2022,Letcher,Kentucky,21133,7424,119,7543
7/10/2022,Lewis,Kentucky,21135,4746,88,4834
7/10/2022,Lincoln,Kentucky,21137,7041,139,7180
7/10/2022,Livingston,Kentucky,21139,2626,61,2687
7/10/2022,Logan,Kentucky,21141,8689,128,8817
7/10/2022,Lyon,Kentucky,21143,3060,36,3096
7/10/2022,Madison,Kentucky,21151,29288,284,29572
7/10/2022,Magoffin,Kentucky,21153,4132,53,4185
7/10/2022,Marion,Kentucky,21155,6701,86,6787
7/10/2022,Marshall,Kentucky,21157,8763,116,8879
7/10/2022,Martin,Kentucky,21159,3430,49,3479
7/10/2022,Mason,Kentucky,21161,5273,108,5381
7/10/2022,McCracken,Kentucky,21145,20806,275,21081
7/10/2022,McCreary,Kentucky,21147,5873,84,5957
7/10/2022,McLean,Kentucky,21149,2733,53,2786
7/10/2022,Meade,Kentucky,21163,6072,66,6138
7/10/2022,Menifee,Kentucky,21165,1814,32,1846
7/10/2022,Mercer,Kentucky,21167,7739,107,7846
7/10/2022,Metcalfe,Kentucky,21169,3008,66,3074
7/10/2022,Monroe,Kentucky,21171,3776,80,3856
7/10/2022,Montgomery,Kentucky,21173,9272,110,9382
7/10/2022,Morgan,Kentucky,21175,5534,33,5567
7/10/2022,Muhlenberg,Kentucky,21177,10730,123,10853
7/10/2022,Nelson,Kentucky,21179,15285,157,15442
7/10/2022,Nicholas,Kentucky,21181,2236,32,2268
7/10/2022,Ohio,Kentucky,21183,7555,105,7660
7/10/2022,Oldham,Kentucky,21185,19624,145,19769
7/10/2022,Owen,Kentucky,21187,2483,34,2517
7/10/2022,Owsley,Kentucky,21189,1603,29,1632
7/10/2022,Pendleton,Kentucky,21191,3629,39,3668
7/10/2022,Perry,Kentucky,21193,11650,184,11834
7/10/2022,Pike,Kentucky,21195,20127,317,20444
7/10/2022,Powell,Kentucky,21197,4960,45,5005
7/10/2022,Pulaski,Kentucky,21199,18805,296,19101
7/10/2022,Robertson,Kentucky,21201,710,21,731
7/10/2022,Rockcastle,Kentucky,21203,5223,63,5286
7/10/2022,Rowan,Kentucky,21205,7153,70,7223
7/10/2022,Russell,Kentucky,21207,6714,88,6802
7/10/2022,Scott,Kentucky,21209,19064,115,19179
7/10/2022,Shelby,Kentucky,21211,14157,167,14324
7/10/2022,Simpson,Kentucky,21213,5983,95,6078
7/10/2022,Spencer,Kentucky,21215,5732,62,5794
7/10/2022,Taylor,Kentucky,21217,9911,126,10037
7/10/2022,Todd,Kentucky,21219,3046,45,3091
7/10/2022,Trigg,Kentucky,21221,4193,45,4238
7/10/2022,Trimble,Kentucky,21223,2277,42,2319
7/10/2022,Union,Kentucky,21225,4436,57,4493
7/10/2022,Warren,Kentucky,21227,45319,382,45701
7/10/2022,Washington,Kentucky,21229,4175,62,4237
7/10/2022,Wayne,Kentucky,21231,6337,93,6430
7/10/2022,Webster,Kentucky,21233,4049,50,4099
7/10/2022,Whitley,Kentucky,21235,14445,208,14653
7/10/2022,Wolfe,Kentucky,21237,2680,29,2709
7/10/2022,Woodford,Kentucky,21239,7591,53,7644
7/10/2022,Acadia,Louisiana,22001,16678,295,16973
7/10/2022,Allen,Louisiana,22003,8162,143,8305
7/10/2022,Ascension,Louisiana,22005,37068,295,37363
7/10/2022,Assumption,Louisiana,22007,5930,70,6000
7/10/2022,Avoyelles,Louisiana,22009,12263,211,12474
7/10/2022,Beauregard,Louisiana,22011,9732,142,9874
7/10/2022,Bienville,Louisiana,22013,4175,111,4286
7/10/2022,Bossier,Louisiana,22015,41438,497,41935
7/10/2022,Caddo,Louisiana,22017,72313,1160,73473
7/10/2022,Calcasieu,Louisiana,22019,57990,714,58704
7/10/2022,Caldwell,Louisiana,22021,3758,55,3813
7/10/2022,Cameron,Louisiana,22023,1227,8,1235
7/10/2022,Catahoula,Louisiana,22025,2764,56,2820
7/10/2022,Claiborne,Louisiana,22027,3401,79,3480
7/10/2022,Concordia,Louisiana,22029,5332,89,5421
7/10/2022,De Soto,Louisiana,22031,8050,135,8185
7/10/2022,East Baton Rouge,Louisiana,22033,119421,1356,120777
7/10/2022,East Carroll,Louisiana,22035,2647,38,2685
7/10/2022,East Feliciana,Louisiana,22037,7510,170,7680
7/10/2022,Evangeline,Louisiana,22039,8839,160,8999
7/10/2022,Franklin,Louisiana,22041,7622,178,7800
7/10/2022,Grant,Louisiana,22043,6210,95,6305
7/10/2022,Iberia,Louisiana,22045,20387,264,20651
7/10/2022,Iberville,Louisiana,22047,9936,152,10088
7/10/2022,Jackson,Louisiana,22049,4631,77,4708
7/10/2022,Jefferson,Louisiana,22051,123848,1354,125202
7/10/2022,Jefferson Davis,Louisiana,22053,7357,160,7517
7/10/2022,Lafayette,Louisiana,22055,66730,505,67235
7/10/2022,Lafourche,Louisiana,22057,29890,378,30268
7/10/2022,LaSalle,Louisiana,22059,4431,61,4492
7/10/2022,Lincoln,Louisiana,22061,12867,145,13012
7/10/2022,Livingston,Louisiana,22063,39058,469,39527
7/10/2022,Madison,Louisiana,22065,3348,58,3406
7/10/2022,Morehouse,Louisiana,22067,7202,134,7336
7/10/2022,Natchitoches,Louisiana,22069,10811,169,10980
7/10/2022,Orleans,Louisiana,22071,98370,1131,99501
7/10/2022,Ouachita,Louisiana,22073,53221,761,53982
7/10/2022,Plaquemines,Louisiana,22075,6945,46,6991
7/10/2022,Pointe Coupee,Louisiana,22077,6763,93,6856
7/10/2022,Rapides,Louisiana,22079,34699,577,35276
7/10/2022,Red River,Louisiana,22081,2203,54,2257
7/10/2022,Richland,Louisiana,22083,7130,100,7230
7/10/2022,Sabine,Louisiana,22085,6673,115,6788
7/10/2022,St. Bernard,Louisiana,22087,12307,112,12419
7/10/2022,St. Charles,Louisiana,22089,14961,144,15105
7/10/2022,St. Helena,Louisiana,22091,2000,24,2024
7/10/2022,St. James,Louisiana,22093,6308,76,6384
7/10/2022,St. John the Baptist,Louisiana,22095,11396,185,11581
7/10/2022,St. Landry,Louisiana,22097,23578,414,23992
7/10/2022,St. Martin,Louisiana,22099,13577,190,13767
7/10/2022,St. Mary,Louisiana,22101,13306,264,13570
7/10/2022,St. Tammany,Louisiana,22103,78438,860,79298
7/10/2022,Tangipahoa,Louisiana,22105,37193,610,37803
7/10/2022,Tensas,Louisiana,22107,1034,12,1046
7/10/2022,Terrebonne,Louisiana,22109,33448,420,33868
7/10/2022,Union,Louisiana,22111,7282,135,7417
7/10/2022,Unknown,Louisiana,,1055,0,1055
7/10/2022,Vermilion,Louisiana,22113,16207,226,16433
7/10/2022,Vernon,Louisiana,22115,10324,191,10515
7/10/2022,Washington,Louisiana,22117,13709,253,13962
7/10/2022,Webster,Louisiana,22119,11920,188,12108
7/10/2022,West Baton Rouge,Louisiana,22121,7820,91,7911
7/10/2022,West Carroll,Louisiana,22123,3857,66,3923
7/10/2022,West Feliciana,Louisiana,22125,2963,46,3009
7/10/2022,Winn,Louisiana,22127,4651,64,4715
7/10/2022,Androscoggin,Maine,23001,24439,294,24733
7/10/2022,Aroostook,Maine,23003,15520,179,15699
7/10/2022,Cumberland,Maine,23005,56899,391,57290
7/10/2022,Franklin,Maine,23007,6363,63,6426
7/10/2022,Hancock,Maine,23009,8613,93,8706
7/10/2022,Kennebec,Maine,23011,26125,253,26378
7/10/2022,Knox,Maine,23013,6839,40,6879
7/10/2022,Lincoln,Maine,23015,5953,38,5991
7/10/2022,Oxford,Maine,23017,12554,153,12707
7/10/2022,Penobscot,Maine,23019,31611,350,31961
7/10/2022,Piscataquis,Maine,23021,3294,34,3328
7/10/2022,Sagadahoc,Maine,23023,5918,37,5955
7/10/2022,Somerset,Maine,23025,10722,113,10835
7/10/2022,Unknown,Maine,,14,0,14
7/10/2022,Waldo,Maine,23027,6927,61,6988
7/10/2022,Washington,Maine,23029,4835,60,4895
7/10/2022,York,Maine,23031,44970,302,45272
7/10/2022,Allegany,Maryland,24001,18127,365,18492
7/10/2022,Anne Arundel,Maryland,24003,101204,1115,102319
7/10/2022,Baltimore,Maryland,24005,146753,2538,149291
7/10/2022,Baltimore city,Maryland,24510,126295,1825,128120
7/10/2022,Calvert,Maryland,24009,12448,150,12598
7/10/2022,Caroline,Maryland,24011,6432,81,6513
7/10/2022,Carroll,Maryland,24013,23860,418,24278
7/10/2022,Cecil,Maryland,24015,17086,262,17348
7/10/2022,Charles,Maryland,24017,31942,358,32300
7/10/2022,Dorchester,Maryland,24019,8278,109,8387
7/10/2022,Frederick,Maryland,24021,50328,535,50863
7/10/2022,Garrett,Maryland,24023,6056,115,6171
7/10/2022,Harford,Maryland,24025,42269,593,42862
7/10/2022,Howard,Maryland,24027,52182,389,52571
7/10/2022,Kent,Maryland,24029,3361,70,3431
7/10/2022,Montgomery,Maryland,24031,201887,2094,203981
7/10/2022,Prince George's,Maryland,24033,189769,2201,191970
7/10/2022,Queen Anne's,Maryland,24035,7697,114,7811
7/10/2022,Somerset,Maryland,24039,5471,76,5547
7/10/2022,St. Mary's,Maryland,24037,20833,219,21052
7/10/2022,Talbot,Maryland,24041,6106,92,6198
7/10/2022,Unknown,Maryland,,0,33,33
7/10/2022,Washington,Maryland,24043,36739,592,37331
7/10/2022,Wicomico,Maryland,24045,21167,331,21498
7/10/2022,Worcester,Maryland,24047,9421,160,9581
7/10/2022,Barnstable,Massachusetts,25001,40818,608,41426
7/10/2022,Berkshire,Massachusetts,25003,29170,395,29565
7/10/2022,Bristol,Massachusetts,25005,162386,2214,164600
7/10/2022,Dukes,Massachusetts,25007,3945,0,3945
7/10/2022,Essex,Massachusetts,25009,226467,2828,229295
7/10/2022,Franklin,Massachusetts,25011,12365,151,12516
7/10/2022,Hampden,Massachusetts,25013,147847,1859,149706
7/10/2022,Hampshire,Massachusetts,25015,33756,368,34124
7/10/2022,Middlesex,Massachusetts,25017,382477,4154,386631
7/10/2022,Nantucket,Massachusetts,25019,3606,0,3606
7/10/2022,Norfolk,Massachusetts,25021,152268,1976,154244
7/10/2022,Plymouth,Massachusetts,25023,126812,1736,128548
7/10/2022,Suffolk,Massachusetts,25025,239792,2050,241842
7/10/2022,Unknown,Massachusetts,,161998,24,162022
7/10/2022,Worcester,Massachusetts,25027,212740,2672,215412
7/10/2022,Alcona,Michigan,26001,1786,72,1858
7/10/2022,Alger,Michigan,26003,1982,14,1996
7/10/2022,Allegan,Michigan,26005,28650,359,29009
7/10/2022,Alpena,Michigan,26007,5936,142,6078
7/10/2022,Antrim,Michigan,26009,4705,70,4775
7/10/2022,Arenac,Michigan,26011,3411,70,3481
7/10/2022,Baraga,Michigan,26013,2348,56,2404
7/10/2022,Barry,Michigan,26015,15115,173,15288
7/10/2022,Bay,Michigan,26017,28668,600,29268
7/10/2022,Benzie,Michigan,26019,3684,70,3754
7/10/2022,Berrien,Michigan,26021,36931,574,37505
7/10/2022,Branch,Michigan,26023,12561,210,12771
7/10/2022,Calhoun,Michigan,26025,36518,589,37107
7/10/2022,Cass,Michigan,26027,11623,148,11771
7/10/2022,Charlevoix,Michigan,26029,5255,60,5315
7/10/2022,Cheboygan,Michigan,26031,5084,108,5192
7/10/2022,Chippewa,Michigan,26033,12246,121,12367
7/10/2022,Clare,Michigan,26035,7146,157,7303
7/10/2022,Clinton,Michigan,26037,23298,211,23509
7/10/2022,Crawford,Michigan,26039,2771,31,2802
7/10/2022,Delta,Michigan,26041,10603,161,10764
7/10/2022,Dickinson,Michigan,26043,7785,113,7898
7/10/2022,Eaton,Michigan,26045,29309,418,29727
7/10/2022,Emmet,Michigan,26047,6884,93,6977
7/10/2022,Genesee,Michigan,26049,109056,1784,110840
7/10/2022,Gladwin,Michigan,26051,5847,116,5963
7/10/2022,Gogebic,Michigan,26053,3529,70,3599
7/10/2022,Grand Traverse,Michigan,26055,18956,243,19199
7/10/2022,Gratiot,Michigan,26057,14380,193,14573
7/10/2022,Hillsdale,Michigan,26059,10890,204,11094
7/10/2022,Houghton,Michigan,26061,8351,98,8449
7/10/2022,Huron,Michigan,26063,8519,147,8666
7/10/2022,Ingham,Michigan,26065,70819,788,71607
7/10/2022,Ionia,Michigan,26067,20501,186,20687
7/10/2022,Iosco,Michigan,26069,5105,149,5254
7/10/2022,Iron,Michigan,26071,2841,88,2929
7/10/2022,Isabella,Michigan,26073,16446,219,16665
7/10/2022,Jackson,Michigan,26075,47636,602,48238
7/10/2022,Kalamazoo,Michigan,26077,64857,690,65547
7/10/2022,Kalkaska,Michigan,26079,3918,62,3980
7/10/2022,Kent,Michigan,26081,179205,1568,180773
7/10/2022,Keweenaw,Michigan,26083,563,13,576
7/10/2022,Lake,Michigan,26085,2023,39,2062
7/10/2022,Lapeer,Michigan,26087,21865,433,22298
7/10/2022,Leelanau,Michigan,26089,3923,59,3982
7/10/2022,Lenawee,Michigan,26091,27849,335,28184
7/10/2022,Livingston,Michigan,26093,50165,465,50630
7/10/2022,Luce,Michigan,26095,2382,16,2398
7/10/2022,Mackinac,Michigan,26097,2659,31,2690
7/10/2022,Macomb,Michigan,26099,253498,4071,257569
7/10/2022,Manistee,Michigan,26101,4785,96,4881
7/10/2022,Marquette,Michigan,26103,17330,139,17469
7/10/2022,Mason,Michigan,26105,7186,96,7282
7/10/2022,Mecosta,Michigan,26107,9168,111,9279
7/10/2022,Menominee,Michigan,26109,5932,72,6004
7/10/2022,Midland,Michigan,26111,20514,232,20746
7/10/2022,Missaukee,Michigan,26113,3076,63,3139
7/10/2022,Monroe,Michigan,26115,41429,483,41912
7/10/2022,Montcalm,Michigan,26117,17948,221,18169
7/10/2022,Montmorency,Michigan,26119,1798,48,1846
7/10/2022,Muskegon,Michigan,26121,44445,655,45100
7/10/2022,Newaygo,Michigan,26123,12087,161,12248
7/10/2022,Oakland,Michigan,26125,323978,3959,327937
7/10/2022,Oceana,Michigan,26127,6715,91,6806
7/10/2022,Ogemaw,Michigan,26129,4531,108,4639
7/10/2022,Ontonagon,Michigan,26131,1072,40,1112
7/10/2022,Osceola,Michigan,26133,5326,83,5409
7/10/2022,Oscoda,Michigan,26135,1525,57,1582
7/10/2022,Otsego,Michigan,26137,6038,104,6142
7/10/2022,Ottawa,Michigan,26139,79426,803,80229
7/10/2022,Presque Isle,Michigan,26141,2197,61,2258
7/10/2022,Roscommon,Michigan,26143,4910,119,5029
7/10/2022,Saginaw,Michigan,26145,54164,976,55140
7/10/2022,Sanilac,Michigan,26151,9129,200,9329
7/10/2022,Schoolcraft,Michigan,26153,1870,16,1886
7/10/2022,Shiawassee,Michigan,26155,18950,232,19182
7/10/2022,St. Clair,Michigan,26147,43473,844,44317
7/10/2022,St. Joseph,Michigan,26149,14188,209,14397
7/10/2022,Tuscola,Michigan,26157,13839,284,14123
7/10/2022,Unknown,Michigan,,19036,82,19118
7/10/2022,Van Buren,Michigan,26159,18121,281,18402
7/10/2022,Washtenaw,Michigan,26161,92090,540,92630
7/10/2022,Wayne,Michigan,26163,445604,8117,453721
7/10/2022,Wexford,Michigan,26165,7571,110,7681
7/10/2022,Aitkin,Minnesota,27001,3196,63,3259
7/10/2022,Anoka,Minnesota,27003,105598,809,106407
7/10/2022,Becker,Minnesota,27005,9288,98,9386
7/10/2022,Beltrami,Minnesota,27007,12590,128,12718
7/10/2022,Benton,Minnesota,27009,14978,179,15157
7/10/2022,Big Stone,Minnesota,27011,1470,9,1479
7/10/2022,Blue Earth,Minnesota,27013,19080,105,19185
7/10/2022,Brown,Minnesota,27015,6873,81,6954
7/10/2022,Carlton,Minnesota,27017,9857,101,9958
7/10/2022,Carver,Minnesota,27019,28850,119,28969
7/10/2022,Cass,Minnesota,27021,7453,84,7537
7/10/2022,Chippewa,Minnesota,27023,3274,48,3322
7/10/2022,Chisago,Minnesota,27025,15463,120,15583
7/10/2022,Clay,Minnesota,27027,20908,128,21036
7/10/2022,Clearwater,Minnesota,27029,2209,31,2240
7/10/2022,Cook,Minnesota,27031,657,4,661
7/10/2022,Cottonwood,Minnesota,27033,3341,41,3382
7/10/2022,Crow Wing,Minnesota,27035,16976,172,17148
7/10/2022,Dakota,Minnesota,27037,120601,799,121400
7/10/2022,Dodge,Minnesota,27039,6121,22,6143
7/10/2022,Douglas,Minnesota,27041,11619,119,11738
7/10/2022,Faribault,Minnesota,27043,4018,54,4072
7/10/2022,Fillmore,Minnesota,27045,5107,24,5131
7/10/2022,Freeborn,Minnesota,27047,9503,78,9581
7/10/2022,Goodhue,Minnesota,27049,14200,142,14342
7/10/2022,Grant,Minnesota,27051,1556,12,1568
7/10/2022,Hennepin,Minnesota,27053,336217,2639,338856
7/10/2022,Houston,Minnesota,27055,4871,20,4891
7/10/2022,Hubbard,Minnesota,27057,5213,60,5273
7/10/2022,Isanti,Minnesota,27059,10658,119,10777
7/10/2022,Itasca,Minnesota,27061,11950,149,12099
7/10/2022,Jackson,Minnesota,27063,2236,17,2253
7/10/2022,Kanabec,Minnesota,27065,3760,57,3817
7/10/2022,Kandiyohi,Minnesota,27067,14095,142,14237
7/10/2022,Kittson,Minnesota,27069,1080,28,1108
7/10/2022,Koochiching,Minnesota,27071,3056,38,3094
7/10/2022,Lac qui Parle,Minnesota,27073,1854,29,1883
7/10/2022,Lake,Minnesota,27075,2288,30,2318
7/10/2022,Lake of the Woods,Minnesota,27077,814,6,820
7/10/2022,Le Sueur,Minnesota,27079,6754,51,6805
7/10/2022,Lincoln,Minnesota,27081,1257,6,1263
7/10/2022,Lyon,Minnesota,27083,7335,74,7409
7/10/2022,Mahnomen,Minnesota,27087,1877,18,1895
7/10/2022,Marshall,Minnesota,27089,2166,24,2190
7/10/2022,Martin,Minnesota,27091,5884,65,5949
7/10/2022,McLeod,Minnesota,27085,11333,109,11442
7/10/2022,Meeker,Minnesota,27093,6257,75,6332
7/10/2022,Mille Lacs,Minnesota,27095,7616,117,7733
7/10/2022,Morrison,Minnesota,27097,9635,106,9741
7/10/2022,Mower,Minnesota,27099,12509,74,12583
7/10/2022,Murray,Minnesota,27101,2121,19,2140
7/10/2022,Nicollet,Minnesota,27103,8736,68,8804
7/10/2022,Nobles,Minnesota,27105,7134,60,7194
7/10/2022,Norman,Minnesota,27107,1583,14,1597
7/10/2022,Olmsted,Minnesota,27109,46529,194,46723
7/10/2022,Otter Tail,Minnesota,27111,14235,172,14407
7/10/2022,Pennington,Minnesota,27113,3792,41,3833
7/10/2022,Pine,Minnesota,27115,7542,68,7610
7/10/2022,Pipestone,Minnesota,27117,2059,34,2093
7/10/2022,Polk,Minnesota,27119,9279,111,9390
7/10/2022,Pope,Minnesota,27121,3362,20,3382
7/10/2022,Ramsey,Minnesota,27123,138077,1373,139450
7/10/2022,Red Lake,Minnesota,27125,964,13,977
7/10/2022,Redwood,Minnesota,27127,4131,54,4185
7/10/2022,Renville,Minnesota,27129,3936,58,3994
7/10/2022,Rice,Minnesota,27131,18998,185,19183
7/10/2022,Rock,Minnesota,27133,2423,35,2458
7/10/2022,Roseau,Minnesota,27135,4631,45,4676
7/10/2022,Scott,Minnesota,27139,43310,266,43576
7/10/2022,Sherburne,Minnesota,27141,28607,183,28790
7/10/2022,Sibley,Minnesota,27143,3741,25,3766
7/10/2022,Stearns,Minnesota,27145,53999,376,54375
7/10/2022,Steele,Minnesota,27147,10974,63,11037
7/10/2022,Stevens,Minnesota,27149,2844,14,2858
7/10/2022,St. Louis,Minnesota,27137,52168,548,52716
7/10/2022,Swift,Minnesota,27151,2389,33,2422
7/10/2022,Todd,Minnesota,27153,7157,61,7218
7/10/2022,Traverse,Minnesota,27155,897,11,908
7/10/2022,Unknown,Minnesota,,905,324,1229
7/10/2022,Wabasha,Minnesota,27157,6028,19,6047
7/10/2022,Wadena,Minnesota,27159,4442,58,4500
7/10/2022,Waseca,Minnesota,27161,5783,39,5822
7/10/2022,Washington,Minnesota,27163,73267,495,73762
7/10/2022,Watonwan,Minnesota,27165,3069,24,3093
7/10/2022,Wilkin,Minnesota,27167,1723,23,1746
7/10/2022,Winona,Minnesota,27169,13944,74,14018
7/10/2022,Wright,Minnesota,27171,38511,307,38818
7/10/2022,Yellow Medicine,Minnesota,27173,2696,31,2727
7/10/2022,Adams,Mississippi,28001,7588,145,7733
7/10/2022,Alcorn,Mississippi,28003,10423,161,10584
7/10/2022,Amite,Mississippi,28005,3377,69,3446
7/10/2022,Attala,Mississippi,28007,5578,114,5692
7/10/2022,Benton,Mississippi,28009,2353,49,2402
7/10/2022,Bolivar,Mississippi,28011,9715,180,9895
7/10/2022,Calhoun,Mississippi,28013,4739,71,4810
7/10/2022,Carroll,Mississippi,28015,2673,55,2728
7/10/2022,Chickasaw,Mississippi,28017,5760,97,5857
7/10/2022,Choctaw,Mississippi,28019,2440,33,2473
7/10/2022,Claiborne,Mississippi,28021,2206,46,2252
7/10/2022,Clarke,Mississippi,28023,4322,108,4430
7/10/2022,Clay,Mississippi,28025,5134,98,5232
7/10/2022,Coahoma,Mississippi,28027,6783,127,6910
7/10/2022,Copiah,Mississippi,28029,7672,121,7793
7/10/2022,Covington,Mississippi,28031,7307,114,7421
7/10/2022,DeSoto,Mississippi,28033,52925,554,53479
7/10/2022,Forrest,Mississippi,28035,22928,316,23244
7/10/2022,Franklin,Mississippi,28037,1968,38,2006
7/10/2022,George,Mississippi,28039,7398,88,7486
7/10/2022,Greene,Mississippi,28041,3314,59,3373
7/10/2022,Grenada,Mississippi,28043,5700,131,5831
7/10/2022,Hancock,Mississippi,28045,12793,153,12946
7/10/2022,Harrison,Mississippi,28047,55999,668,56667
7/10/2022,Hinds,Mississippi,28049,55667,795,56462
7/10/2022,Holmes,Mississippi,28051,4542,104,4646
7/10/2022,Humphreys,Mississippi,28053,2083,47,2130
7/10/2022,Issaquena,Mississippi,28055,274,9,283
7/10/2022,Itawamba,Mississippi,28057,7646,144,7790
7/10/2022,Jackson,Mississippi,28059,38643,464,39107
7/10/2022,Jasper,Mississippi,28061,5131,75,5206
7/10/2022,Jefferson,Mississippi,28063,1539,37,1576
7/10/2022,Jefferson Davis,Mississippi,28065,2955,54,3009
7/10/2022,Jones,Mississippi,28067,21759,296,22055
7/10/2022,Kemper,Mississippi,28069,2270,48,2318
7/10/2022,Lafayette,Mississippi,28071,16063,179,16242
7/10/2022,Lamar,Mississippi,28073,18178,160,18338
7/10/2022,Lauderdale,Mississippi,28075,19403,370,19773
7/10/2022,Lawrence,Mississippi,28077,3732,56,3788
7/10/2022,Leake,Mississippi,28079,6593,120,6713
7/10/2022,Lee,Mississippi,28081,27857,302,28159
7/10/2022,Leflore,Mississippi,28083,7637,170,7807
7/10/2022,Lincoln,Mississippi,28085,8643,158,8801
7/10/2022,Lowndes,Mississippi,28087,18076,240,18316
7/10/2022,Madison,Mississippi,28089,25833,332,26165
7/10/2022,Marion,Mississippi,28091,7195,136,7331
7/10/2022,Marshall,Mississippi,28093,10342,176,10518
7/10/2022,Monroe,Mississippi,28095,11267,222,11489
7/10/2022,Montgomery,Mississippi,28097,3062,79,3141
7/10/2022,Neshoba,Mississippi,28099,10873,241,11114
7/10/2022,Newton,Mississippi,28101,6227,98,6325
7/10/2022,Noxubee,Mississippi,28103,2781,48,2829
7/10/2022,Oktibbeha,Mississippi,28105,11506,163,11669
7/10/2022,Panola,Mississippi,28107,10926,170,11096
7/10/2022,Pearl River,Mississippi,28109,15653,276,15929
7/10/2022,Perry,Mississippi,28111,3146,64,3210
7/10/2022,Pike,Mississippi,28113,10113,189,10302
7/10/2022,Pontotoc,Mississippi,28115,10681,147,10828
7/10/2022,Prentiss,Mississippi,28117,8453,103,8556
7/10/2022,Quitman,Mississippi,28119,1646,31,1677
7/10/2022,Rankin,Mississippi,28121,38639,490,39129
7/10/2022,Scott,Mississippi,28123,6743,119,6862
7/10/2022,Sharkey,Mississippi,28125,1019,27,1046
7/10/2022,Simpson,Mississippi,28127,7259,150,7409
7/10/2022,Smith,Mississippi,28129,4254,69,4323
7/10/2022,Stone,Mississippi,28131,5563,72,5635
7/10/2022,Sunflower,Mississippi,28133,5899,126,6025
7/10/2022,Tallahatchie,Mississippi,28135,3294,60,3354
7/10/2022,Tate,Mississippi,28137,7706,144,7850
7/10/2022,Tippah,Mississippi,28139,7635,109,7744
7/10/2022,Tishomingo,Mississippi,28141,6375,122,6497
7/10/2022,Tunica,Mississippi,28143,2690,48,2738
7/10/2022,Union,Mississippi,28145,9773,123,9896
7/10/2022,Unknown,Mississippi,,14139,33,14172
7/10/2022,Walthall,Mississippi,28147,3746,80,3826
7/10/2022,Warren,Mississippi,28149,10754,203,10957
7/10/2022,Washington,Mississippi,28151,10771,200,10971
7/10/2022,Wayne,Mississippi,28153,6109,87,6196
7/10/2022,Webster,Mississippi,28155,3453,70,3523
7/10/2022,Wilkinson,Mississippi,28157,1836,46,1882
7/10/2022,Winston,Mississippi,28159,5455,104,5559
7/10/2022,Yalobusha,Mississippi,28161,4282,57,4339
7/10/2022,Yazoo,Mississippi,28163,8321,108,8429
7/10/2022,Adair,Missouri,29001,5817,67,5884
7/10/2022,Andrew,Missouri,29003,4997,59,5056
7/10/2022,Atchison,Missouri,29005,1457,23,1480
7/10/2022,Audrain,Missouri,29007,5893,114,6007
7/10/2022,Barry,Missouri,29009,6924,143,7067
7/10/2022,Barton,Missouri,29011,2976,52,3028
7/10/2022,Bates,Missouri,29013,3875,97,3972
7/10/2022,Benton,Missouri,29015,4465,108,4573
7/10/2022,Bollinger,Missouri,29017,2745,43,2788
7/10/2022,Boone,Missouri,29019,48002,261,48263
7/10/2022,Buchanan,Missouri,29021,25513,322,25835
7/10/2022,Butler,Missouri,29023,10501,175,10676
7/10/2022,Caldwell,Missouri,29025,1783,39,1822
7/10/2022,Callaway,Missouri,29027,12575,133,12708
7/10/2022,Camden,Missouri,29029,9697,183,9880
7/10/2022,Cape Girardeau,Missouri,29031,19787,247,20034
7/10/2022,Carroll,Missouri,29033,2282,45,2327
7/10/2022,Carter,Missouri,29035,1530,24,1554
7/10/2022,Cass,Missouri,29037,26489,319,26808
7/10/2022,Cedar,Missouri,29039,3107,57,3164
7/10/2022,Chariton,Missouri,29041,1773,38,1811
7/10/2022,Christian,Missouri,29043,22031,268,22299
7/10/2022,Clark,Missouri,29045,1685,40,1725
7/10/2022,Clay,Missouri,29047,28894,369,29263
7/10/2022,Clinton,Missouri,29049,4962,122,5084
7/10/2022,Cole,Missouri,29051,21093,291,21384
7/10/2022,Cooper,Missouri,29053,4229,78,4307
7/10/2022,Crawford,Missouri,29055,5632,107,5739
7/10/2022,Dade,Missouri,29057,1530,43,1573
7/10/2022,Dallas,Missouri,29059,4012,74,4086
7/10/2022,Daviess,Missouri,29061,1783,30,1813
7/10/2022,DeKalb,Missouri,29063,2286,47,2333
7/10/2022,Dent,Missouri,29065,3397,87,3484
7/10/2022,Douglas,Missouri,29067,2648,81,2729
7/10/2022,Dunklin,Missouri,29069,8293,127,8420
7/10/2022,Franklin,Missouri,29071,27282,379,27661
7/10/2022,Gasconade,Missouri,29073,3541,103,3644
7/10/2022,Gentry,Missouri,29075,2248,32,2280
7/10/2022,Greene,Missouri,29077,75213,1051,76264
7/10/2022,Grundy,Missouri,29079,2692,69,2761
7/10/2022,Harrison,Missouri,29081,1963,35,1998
7/10/2022,Henry,Missouri,29083,5972,88,6060
7/10/2022,Hickory,Missouri,29085,1938,56,1994
7/10/2022,Holt,Missouri,29087,1123,30,1153
7/10/2022,Howard,Missouri,29089,2580,30,2610
7/10/2022,Howell,Missouri,29091,9458,220,9678
7/10/2022,Iron,Missouri,29093,2277,44,2321
7/10/2022,Jackson,Missouri,29095,102034,1231,103265
7/10/2022,Jasper,Missouri,29097,21712,323,22035
7/10/2022,Jefferson,Missouri,29099,58128,665,58793
7/10/2022,Johnson,Missouri,29101,12700,145,12845
7/10/2022,Joplin,Missouri,,14436,221,14657
7/10/2022,Kansas City,Missouri,,121449,1329,122778
7/10/2022,Knox,Missouri,29103,1056,14,1070
7/10/2022,Laclede,Missouri,29105,8423,179,8602
7/10/2022,Lafayette,Missouri,29107,8151,137,8288
7/10/2022,Lawrence,Missouri,29109,8103,168,8271
7/10/2022,Lewis,Missouri,29111,2911,43,2954
7/10/2022,Lincoln,Missouri,29113,15987,141,16128
7/10/2022,Linn,Missouri,29115,2705,65,2770
7/10/2022,Livingston,Missouri,29117,3883,98,3981
7/10/2022,Macon,Missouri,29121,3811,59,3870
7/10/2022,Madison,Missouri,29123,3739,57,3796
7/10/2022,Maries,Missouri,29125,1684,39,1723
7/10/2022,Marion,Missouri,29127,8391,124,8515
7/10/2022,McDonald,Missouri,29119,5936,81,6017
7/10/2022,Mercer,Missouri,29129,756,14,770
7/10/2022,Miller,Missouri,29131,6303,124,6427
7/10/2022,Mississippi,Missouri,29133,3622,59,3681
7/10/2022,Moniteau,Missouri,29135,3911,57,3968
7/10/2022,Monroe,Missouri,29137,2235,45,2280
7/10/2022,Montgomery,Missouri,29139,2637,58,2695
7/10/2022,Morgan,Missouri,29141,4204,115,4319
7/10/2022,New Madrid,Missouri,29143,5170,86,5256
7/10/2022,Newton,Missouri,29145,12283,208,12491
7/10/2022,Nodaway,Missouri,29147,6299,46,6345
7/10/2022,Oregon,Missouri,29149,2093,37,2130
7/10/2022,Osage,Missouri,29151,3327,46,3373
7/10/2022,Ozark,Missouri,29153,1787,62,1849
7/10/2022,Pemiscot,Missouri,29155,3169,81,3250
7/10/2022,Perry,Missouri,29157,5320,46,5366
7/10/2022,Pettis,Missouri,29159,12793,173,12966
7/10/2022,Phelps,Missouri,29161,10834,246,11080
7/10/2022,Pike,Missouri,29163,4436,64,4500
7/10/2022,Platte,Missouri,29165,11187,102,11289
7/10/2022,Polk,Missouri,29167,8486,109,8595
7/10/2022,Pulaski,Missouri,29169,9447,117,9564
7/10/2022,Putnam,Missouri,29171,1085,25,1110
7/10/2022,Ralls,Missouri,29173,2576,28,2604
7/10/2022,Randolph,Missouri,29175,6273,105,6378
7/10/2022,Ray,Missouri,29177,5421,95,5516
7/10/2022,Reynolds,Missouri,29179,1199,26,1225
7/10/2022,Ripley,Missouri,29181,2777,61,2838
7/10/2022,Saline,Missouri,29195,6458,109,6567
7/10/2022,Schuyler,Missouri,29197,770,26,796
7/10/2022,Scotland,Missouri,29199,695,18,713
7/10/2022,Scott,Missouri,29201,11526,162,11688
7/10/2022,Shannon,Missouri,29203,1652,40,1692
7/10/2022,Shelby,Missouri,29205,1725,15,1740
7/10/2022,St. Charles,Missouri,29183,111871,951,112822
7/10/2022,St. Clair,Missouri,29185,2183,37,2220
7/10/2022,Ste. Genevieve,Missouri,29186,3937,39,3976
7/10/2022,St. Francois,Missouri,29187,19862,300,20162
7/10/2022,St. Louis,Missouri,29189,249017,3402,252419
7/10/2022,St. Louis city,Missouri,29510,63998,795,64793
7/10/2022,Stoddard,Missouri,29207,6287,139,6426
7/10/2022,Stone,Missouri,29209,6131,123,6254
7/10/2022,Sullivan,Missouri,29211,1769,23,1792
7/10/2022,Taney,Missouri,29213,14072,233,14305
7/10/2022,Texas,Missouri,29215,4884,107,4991
7/10/2022,Vernon,Missouri,29217,5361,110,5471
7/10/2022,Warren,Missouri,29219,8640,104,8744
7/10/2022,Washington,Missouri,29221,6234,143,6377
7/10/2022,Wayne,Missouri,29223,2478,54,2532
7/10/2022,Webster,Missouri,29225,9321,153,9474
7/10/2022,Worth,Missouri,29227,424,3,427
7/10/2022,Wright,Missouri,29229,3996,90,4086
7/10/2022,Beaverhead,Montana,30001,2240,30,2270
7/10/2022,Big Horn,Montana,30003,5070,100,5170
7/10/2022,Blaine,Montana,30005,2169,33,2202
7/10/2022,Broadwater,Montana,30007,1349,21,1370
7/10/2022,Carbon,Montana,30009,2159,28,2187
7/10/2022,Carter,Montana,30011,262,5,267
7/10/2022,Cascade,Montana,30013,26316,348,26664
7/10/2022,Chouteau,Montana,30015,1042,15,1057
7/10/2022,Custer,Montana,30017,3126,49,3175
7/10/2022,Daniels,Montana,30019,401,9,410
7/10/2022,Dawson,Montana,30021,2422,58,2480
7/10/2022,Deer Lodge,Montana,30023,2732,29,2761
7/10/2022,Fallon,Montana,30025,699,10,709
7/10/2022,Fergus,Montana,30027,2584,57,2641
7/10/2022,Flathead,Montana,30029,30624,288,30912
7/10/2022,Gallatin,Montana,30031,37525,123,37648
7/10/2022,Garfield,Montana,30033,243,3,246
7/10/2022,Glacier,Montana,30035,4152,75,4227
7/10/2022,Golden Valley,Montana,30037,152,5,157
7/10/2022,Granite,Montana,30039,575,10,585
7/10/2022,Hill,Montana,30041,4726,73,4799
7/10/2022,Jefferson,Montana,30043,2769,25,2794
7/10/2022,Judith Basin,Montana,30045,236,1,237
7/10/2022,Lake,Montana,30047,7103,101,7204
7/10/2022,Lewis and Clark,Montana,30049,19061,191,19252
7/10/2022,Liberty,Montana,30051,435,4,439
7/10/2022,Lincoln,Montana,30053,4997,91,5088
7/10/2022,Madison,Montana,30057,1971,22,1993
7/10/2022,McCone,Montana,30055,394,9,403
7/10/2022,Meagher,Montana,30059,462,10,472
7/10/2022,Mineral,Montana,30061,1181,17,1198
7/10/2022,Missoula,Montana,30063,29579,212,29791
7/10/2022,Musselshell,Montana,30065,948,31,979
7/10/2022,Park,Montana,30067,4627,35,4662
7/10/2022,Petroleum,Montana,30069,35,1,36
7/10/2022,Phillips,Montana,30071,1084,29,1113
7/10/2022,Pondera,Montana,30073,1249,9,1258
7/10/2022,Powder River,Montana,30075,365,10,375
7/10/2022,Powell,Montana,30077,1936,29,1965
7/10/2022,Prairie,Montana,30079,270,3,273
7/10/2022,Ravalli,Montana,30081,7404,165,7569
7/10/2022,Richland,Montana,30083,2717,36,2753
7/10/2022,Roosevelt,Montana,30085,3356,75,3431
7/10/2022,Rosebud,Montana,30087,2701,61,2762
7/10/2022,Sanders,Montana,30089,2225,52,2277
7/10/2022,Sheridan,Montana,30091,752,11,763
7/10/2022,Silver Bow,Montana,30093,8924,134,9058
7/10/2022,Stillwater,Montana,30095,1586,32,1618
7/10/2022,Sweet Grass,Montana,30097,812,13,825
7/10/2022,Teton,Montana,30099,1355,24,1379
7/10/2022,Toole,Montana,30101,1293,25,1318
7/10/2022,Treasure,Montana,30103,136,1,137
7/10/2022,Valley,Montana,30105,1800,38,1838
7/10/2022,Wheatland,Montana,30107,395,14,409
7/10/2022,Wibaux,Montana,30109,208,8,216
7/10/2022,Yellowstone,Montana,30111,44737,562,45299
7/10/2022,Adams,Nebraska,31001,6805,73,6878
7/10/2022,Antelope,Nebraska,31003,1117,14,1131
7/10/2022,Arthur,Nebraska,31005,33,1,34
7/10/2022,Banner,Nebraska,31007,91,2,93
7/10/2022,Blaine,Nebraska,31009,68,3,71
7/10/2022,Boone,Nebraska,31011,1105,5,1110
7/10/2022,Box Butte,Nebraska,31013,2299,17,2316
7/10/2022,Boyd,Nebraska,31015,416,7,423
7/10/2022,Brown,Nebraska,31017,566,4,570
7/10/2022,Buffalo,Nebraska,31019,12486,104,12590
7/10/2022,Burt,Nebraska,31021,1354,17,1371
7/10/2022,Butler,Nebraska,31023,2004,18,2022
7/10/2022,Cass,Nebraska,31025,6403,46,6449
7/10/2022,Cedar,Nebraska,31027,1520,14,1534
7/10/2022,Chase,Nebraska,31029,826,7,833
7/10/2022,Cherry,Nebraska,31031,561,12,573
7/10/2022,Cheyenne,Nebraska,31033,2085,24,2109
7/10/2022,Clay,Nebraska,31035,1555,25,1580
7/10/2022,Colfax,Nebraska,31037,2729,28,2757
7/10/2022,Cuming,Nebraska,31039,1859,15,1874
7/10/2022,Custer,Nebraska,31041,2089,31,2120
7/10/2022,Dakota,Nebraska,31043,6978,82,7060
7/10/2022,Dawes,Nebraska,31045,1409,21,1430
7/10/2022,Dawson,Nebraska,31047,5413,44,5457
7/10/2022,Deuel,Nebraska,31049,325,3,328
7/10/2022,Dixon,Nebraska,31051,1237,11,1248
7/10/2022,Dodge,Nebraska,31053,10435,111,10546
7/10/2022,Douglas,Nebraska,31055,158956,1136,160092
7/10/2022,Dundy,Nebraska,31057,340,6,346
7/10/2022,Fillmore,Nebraska,31059,1169,13,1182
7/10/2022,Franklin,Nebraska,31061,429,13,442
7/10/2022,Frontier,Nebraska,31063,556,3,559
7/10/2022,Furnas,Nebraska,31065,1162,8,1170
7/10/2022,Gage,Nebraska,31067,3656,45,3701
7/10/2022,Garden,Nebraska,31069,387,1,388
7/10/2022,Garfield,Nebraska,31071,408,2,410
7/10/2022,Gosper,Nebraska,31073,403,7,410
7/10/2022,Grant,Nebraska,31075,101,6,107
7/10/2022,Greeley,Nebraska,31077,430,2,432
7/10/2022,Hall,Nebraska,31079,17009,146,17155
7/10/2022,Hamilton,Nebraska,31081,2382,25,2407
7/10/2022,Harlan,Nebraska,31083,356,3,359
7/10/2022,Hayes,Nebraska,31085,99,0,99
7/10/2022,Hitchcock,Nebraska,31087,561,8,569
7/10/2022,Holt,Nebraska,31089,2259,20,2279
7/10/2022,Hooker,Nebraska,31091,113,5,118
7/10/2022,Howard,Nebraska,31093,1224,15,1239
7/10/2022,Jefferson,Nebraska,31095,1252,7,1259
7/10/2022,Johnson,Nebraska,31097,882,10,892
7/10/2022,Kearney,Nebraska,31099,1258,9,1267
7/10/2022,Keith,Nebraska,31101,1591,20,1611
7/10/2022,Keya Paha,Nebraska,31103,122,0,122
7/10/2022,Kimball,Nebraska,31105,756,9,765
7/10/2022,Knox,Nebraska,31107,1707,13,1720
7/10/2022,Lancaster,Nebraska,31109,82859,444,83303
7/10/2022,Lincoln,Nebraska,31111,9140,120,9260
7/10/2022,Logan,Nebraska,31113,145,0,145
7/10/2022,Loup,Nebraska,31115,82,0,82
7/10/2022,Madison,Nebraska,31119,9923,70,9993
7/10/2022,McPherson,Nebraska,31117,69,1,70
7/10/2022,Merrick,Nebraska,31121,1761,17,1778
7/10/2022,Morrill,Nebraska,31123,1182,21,1203
7/10/2022,Nance,Nebraska,31125,799,12,811
7/10/2022,Nemaha,Nebraska,31127,1386,20,1406
7/10/2022,Nuckolls,Nebraska,31129,998,13,1011
7/10/2022,Otoe,Nebraska,31131,3501,20,3521
7/10/2022,Pawnee,Nebraska,31133,454,4,458
7/10/2022,Perkins,Nebraska,31135,539,12,551
7/10/2022,Phelps,Nebraska,31137,2408,14,2422
7/10/2022,Pierce,Nebraska,31139,1281,21,1302
7/10/2022,Platte,Nebraska,31141,8865,75,8940
7/10/2022,Polk,Nebraska,31143,1225,18,1243
7/10/2022,Red Willow,Nebraska,31145,2405,20,2425
7/10/2022,Richardson,Nebraska,31147,1855,24,1879
7/10/2022,Rock,Nebraska,31149,182,2,184
7/10/2022,Saline,Nebraska,31151,3862,12,3874
7/10/2022,Sarpy,Nebraska,31153,52286,286,52572
7/10/2022,Saunders,Nebraska,31155,5137,30,5167
7/10/2022,Scotts Bluff,Nebraska,31157,9740,102,9842
7/10/2022,Seward,Nebraska,31159,3450,43,3493
7/10/2022,Sheridan,Nebraska,31161,997,23,1020
7/10/2022,Sherman,Nebraska,31163,609,4,613
7/10/2022,Sioux,Nebraska,31165,74,1,75
7/10/2022,Stanton,Nebraska,31167,662,11,673
7/10/2022,Thayer,Nebraska,31169,1143,8,1151
7/10/2022,Thomas,Nebraska,31171,104,1,105
7/10/2022,Thurston,Nebraska,31173,1777,23,1800
7/10/2022,Unknown,Nebraska,,7515,506,8021
7/10/2022,Valley,Nebraska,31175,768,6,774
7/10/2022,Washington,Nebraska,31177,4764,45,4809
7/10/2022,Wayne,Nebraska,31179,1890,11,1901
7/10/2022,Webster,Nebraska,31181,729,11,740
7/10/2022,Wheeler,Nebraska,31183,124,2,126
7/10/2022,York,Nebraska,31185,4083,21,4104
7/10/2022,Carson City,Nevada,32510,15793,224,16017
7/10/2022,Churchill,Nevada,32001,6870,116,6986
7/10/2022,Clark,Nevada,32003,588167,8660,596827
7/10/2022,Douglas,Nevada,32005,7960,93,8053
7/10/2022,Elko,Nevada,32007,12029,139,12168
7/10/2022,Esmeralda,Nevada,32009,110,3,113
7/10/2022,Eureka,Nevada,32011,172,2,174
7/10/2022,Humboldt,Nevada,32013,2614,58,2672
7/10/2022,Lander,Nevada,32015,1209,21,1230
7/10/2022,Lincoln,Nevada,32017,554,8,562
7/10/2022,Lyon,Nevada,32019,10881,178,11059
7/10/2022,Mineral,Nevada,32021,1352,18,1370
7/10/2022,Nye,Nevada,32023,8032,274,8306
7/10/2022,Pershing,Nevada,32027,2224,30,2254
7/10/2022,Storey,Nevada,32029,156,11,167
7/10/2022,Unknown,Nevada,,8127,43,8170
7/10/2022,Washoe,Nevada,32031,115015,1217,116232
7/10/2022,White Pine,Nevada,32033,1707,22,1729
7/10/2022,Belknap,New Hampshire,33001,15082,186,15268
7/10/2022,Carroll,New Hampshire,33003,10617,65,10682
7/10/2022,Cheshire,New Hampshire,33005,16709,118,16827
7/10/2022,Coos,New Hampshire,33007,7560,118,7678
7/10/2022,Grafton,New Hampshire,33009,20644,74,20718
7/10/2022,Hillsborough,New Hampshire,33011,107282,939,108221
7/10/2022,Merrimack,New Hampshire,33013,35151,243,35394
7/10/2022,Rockingham,New Hampshire,33015,74854,563,75417
7/10/2022,Strafford,New Hampshire,33017,32866,218,33084
7/10/2022,Sullivan,New Hampshire,33019,10287,71,10358
7/10/2022,Unknown,New Hampshire,,2737,7,2744
7/10/2022,Atlantic,New Jersey,34001,76237,1022,77259
7/10/2022,Bergen,New Jersey,34003,263961,3515,267476
7/10/2022,Burlington,New Jersey,34005,116895,1255,118150
7/10/2022,Camden,New Jersey,34007,140764,1855,142619
7/10/2022,Cape May,New Jersey,34009,24961,311,25272
7/10/2022,Cumberland,New Jersey,34011,43055,616,43671
7/10/2022,Essex,New Jersey,34013,241362,3637,244999
7/10/2022,Gloucester,New Jersey,34015,77458,984,78442
7/10/2022,Hudson,New Jersey,34017,196062,2746,198808
7/10/2022,Hunterdon,New Jersey,34019,28459,280,28739
7/10/2022,Mercer,New Jersey,34021,89700,1283,90983
7/10/2022,Middlesex,New Jersey,34023,225295,2897,228192
7/10/2022,Monmouth,New Jersey,34025,187183,2239,189422
7/10/2022,Morris,New Jersey,34027,138534,1580,140114
7/10/2022,Ocean,New Jersey,34029,180347,3046,183393
7/10/2022,Passaic,New Jersey,34031,160907,2360,163267
7/10/2022,Salem,New Jersey,34033,15552,252,15804
7/10/2022,Somerset,New Jersey,34035,80175,984,81159
7/10/2022,Sussex,New Jersey,34037,38052,501,38553
7/10/2022,Union,New Jersey,34039,163190,2398,165588
7/10/2022,Unknown,New Jersey,,3055,0,3055
7/10/2022,Warren,New Jersey,34041,26630,346,26976
7/10/2022,Bernalillo,New Mexico,35001,165853,1960,167813
7/10/2022,Catron,New Mexico,35003,439,15,454
7/10/2022,Chaves,New Mexico,35005,22406,340,22746
7/10/2022,Cibola,New Mexico,35006,8760,197,8957
7/10/2022,Colfax,New Mexico,35007,2803,67,2870
7/10/2022,Curry,New Mexico,35009,13447,212,13659
7/10/2022,De Baca,New Mexico,35011,621,6,627
7/10/2022,Do�a Ana,New Mexico,35013,67588,807,68395
7/10/2022,Eddy,New Mexico,35015,17498,291,17789
7/10/2022,Grant,New Mexico,35017,7768,95,7863
7/10/2022,Guadalupe,New Mexico,35019,1536,17,1553
7/10/2022,Harding,New Mexico,35021,90,4,94
7/10/2022,Hidalgo,New Mexico,35023,1160,15,1175
7/10/2022,Lea,New Mexico,35025,20655,360,21015
7/10/2022,Lincoln,New Mexico,35027,5647,68,5715
7/10/2022,Los Alamos,New Mexico,35028,3777,17,3794
7/10/2022,Luna,New Mexico,35029,7138,133,7271
7/10/2022,McKinley,New Mexico,35031,27811,593,28404
7/10/2022,Mora,New Mexico,35033,862,20,882
7/10/2022,Otero,New Mexico,35035,16369,192,16561
7/10/2022,Quay,New Mexico,35037,2128,58,2186
7/10/2022,Rio Arriba,New Mexico,35039,11133,145,11278
7/10/2022,Roosevelt,New Mexico,35041,5207,98,5305
7/10/2022,Sandoval,New Mexico,35043,37840,458,38298
7/10/2022,San Juan,New Mexico,35045,43985,785,44770
7/10/2022,San Miguel,New Mexico,35047,6550,67,6617
7/10/2022,Santa Fe,New Mexico,35049,33942,318,34260
7/10/2022,Sierra,New Mexico,35051,2248,78,2326
7/10/2022,Socorro,New Mexico,35053,4087,92,4179
7/10/2022,Taos,New Mexico,35055,6118,96,6214
7/10/2022,Torrance,New Mexico,35057,3349,58,3407
7/10/2022,Union,New Mexico,35059,1044,17,1061
7/10/2022,Unknown,New Mexico,,205,0,205
7/10/2022,Valencia,New Mexico,35061,20802,286,21088
7/10/2022,Albany,New York,36001,67942,542,68484
7/10/2022,Allegany,New York,36003,9657,157,9814
7/10/2022,Broome,New York,36007,51220,534,51754
7/10/2022,Cattaraugus,New York,36009,16946,226,17172
7/10/2022,Cayuga,New York,36011,17884,160,18044
7/10/2022,Chautauqua,New York,36013,25944,306,26250
7/10/2022,Chemung,New York,36015,23496,238,23734
7/10/2022,Chenango,New York,36017,10304,124,10428
7/10/2022,Clinton,New York,36019,19281,93,19374
7/10/2022,Columbia,New York,36021,11651,150,11801
7/10/2022,Cortland,New York,36023,11704,123,11827
7/10/2022,Delaware,New York,36025,8804,79,8883
7/10/2022,Dutchess,New York,36027,71837,670,72507
7/10/2022,Erie,New York,36029,238724,2699,241423
7/10/2022,Essex,New York,36031,6579,64,6643
7/10/2022,Franklin,New York,36033,10530,47,10577
7/10/2022,Fulton,New York,36035,14149,173,14322
7/10/2022,Genesee,New York,36037,14924,193,15117
7/10/2022,Greene,New York,36039,9576,134,9710
7/10/2022,Hamilton,New York,36041,959,5,964
7/10/2022,Herkimer,New York,36043,15404,197,15601
7/10/2022,Jefferson,New York,36045,22625,142,22767
7/10/2022,Lewis,New York,36049,6604,50,6654
7/10/2022,Livingston,New York,36051,12825,121,12946
7/10/2022,Madison,New York,36053,14806,129,14935
7/10/2022,Monroe,New York,36055,170927,1648,172575
7/10/2022,Montgomery,New York,36057,13123,209,13332
7/10/2022,Nassau,New York,36059,461003,3915,464918
7/10/2022,New York City,New York,,2625377,40831,2666208
7/10/2022,Niagara,New York,36063,53475,597,54072
7/10/2022,Oneida,New York,36065,60727,818,61545
7/10/2022,Onondaga,New York,36067,125946,1093,127039
7/10/2022,Ontario,New York,36069,22645,189,22834
7/10/2022,Orange,New York,36071,118115,977,119092
7/10/2022,Orleans,New York,36073,9452,119,9571
7/10/2022,Oswego,New York,36075,29758,200,29958
7/10/2022,Otsego,New York,36077,11437,94,11531
7/10/2022,Putnam,New York,36079,26782,125,26907
7/10/2022,Rensselaer,New York,36083,36242,275,36517
7/10/2022,Rockland,New York,36087,101949,909,102858
7/10/2022,Saratoga,New York,36091,53342,349,53691
7/10/2022,Schenectady,New York,36093,37899,317,38216
7/10/2022,Schoharie,New York,36095,5641,36,5677
7/10/2022,Schuyler,New York,36097,3895,28,3923
7/10/2022,Seneca,New York,36099,6625,93,6718
7/10/2022,Steuben,New York,36101,22245,258,22503
7/10/2022,St. Lawrence,New York,36089,23273,198,23471
7/10/2022,Suffolk,New York,36103,477125,4489,481614
7/10/2022,Sullivan,New York,36105,20563,133,20696
7/10/2022,Tioga,New York,36107,12221,86,12307
7/10/2022,Tompkins,New York,36109,22825,89,22914
7/10/2022,Ulster,New York,36111,36270,375,36645
7/10/2022,Warren,New York,36113,15925,131,16056
7/10/2022,Washington,New York,36115,13645,120,13765
7/10/2022,Wayne,New York,36117,19200,185,19385
7/10/2022,Westchester,New York,36119,285689,2751,288440
7/10/2022,Wyoming,New York,36121,9019,85,9104
7/10/2022,Yates,New York,36123,3863,40,3903
7/10/2022,Alamance,North Carolina,37001,51149,501,51650
7/10/2022,Alexander,North Carolina,37003,10745,144,10889
7/10/2022,Alleghany,North Carolina,37005,3091,17,3108
7/10/2022,Anson,North Carolina,37007,6947,100,7047
7/10/2022,Ashe,North Carolina,37009,6545,84,6629
7/10/2022,Avery,North Carolina,37011,4809,46,4855
7/10/2022,Beaufort,North Carolina,37013,13442,177,13619
7/10/2022,Bertie,North Carolina,37015,4529,70,4599
7/10/2022,Bladen,North Carolina,37017,9962,133,10095
7/10/2022,Brunswick,North Carolina,37019,33412,339,33751
7/10/2022,Buncombe,North Carolina,37021,59358,612,59970
7/10/2022,Burke,North Carolina,37023,26461,333,26794
7/10/2022,Cabarrus,North Carolina,37025,60492,508,61000
7/10/2022,Caldwell,North Carolina,37027,23558,309,23867
7/10/2022,Camden,North Carolina,37029,1896,9,1905
7/10/2022,Carteret,North Carolina,37031,15442,132,15574
7/10/2022,Caswell,North Carolina,37033,5735,53,5788
7/10/2022,Catawba,North Carolina,37035,50503,614,51117
7/10/2022,Chatham,North Carolina,37037,14591,120,14711
7/10/2022,Cherokee,North Carolina,37039,7430,125,7555
7/10/2022,Chowan,North Carolina,37041,4399,61,4460
7/10/2022,Clay,North Carolina,37043,2773,47,2820
7/10/2022,Cleveland,North Carolina,37045,31081,405,31486
7/10/2022,Columbus,North Carolina,37047,16518,271,16789
7/10/2022,Craven,North Carolina,37049,26663,209,26872
7/10/2022,Cumberland,North Carolina,37051,94697,662,95359
7/10/2022,Currituck,North Carolina,37053,5406,37,5443
7/10/2022,Dare,North Carolina,37055,8397,27,8424
7/10/2022,Davidson,North Carolina,37057,46126,435,46561
7/10/2022,Davie,North Carolina,37059,12196,109,12305
7/10/2022,Duplin,North Carolina,37061,17417,248,17665
7/10/2022,Durham,North Carolina,37063,85288,343,85631
7/10/2022,Edgecombe,North Carolina,37065,14423,155,14578
7/10/2022,Forsyth,North Carolina,37067,101906,842,102748
7/10/2022,Franklin,North Carolina,37069,22486,82,22568
7/10/2022,Gaston,North Carolina,37071,69489,866,70355
7/10/2022,Gates,North Carolina,37073,2037,20,2057
7/10/2022,Graham,North Carolina,37075,2366,31,2397
7/10/2022,Granville,North Carolina,37077,15814,118,15932
7/10/2022,Greene,North Carolina,37079,6138,70,6208
7/10/2022,Guilford,North Carolina,37081,131569,1244,132813
7/10/2022,Halifax,North Carolina,37083,14987,188,15175
7/10/2022,Harnett,North Carolina,37085,35873,345,36218
7/10/2022,Haywood,North Carolina,37087,14162,224,14386
7/10/2022,Henderson,North Carolina,37089,26843,326,27169
7/10/2022,Hertford,North Carolina,37091,5063,88,5151
7/10/2022,Hoke,North Carolina,37093,16198,120,16318
7/10/2022,Hyde,North Carolina,37095,1464,14,1478
7/10/2022,Iredell,North Carolina,37097,51928,482,52410
7/10/2022,Jackson,North Carolina,37099,10328,99,10427
7/10/2022,Johnston,North Carolina,37101,64254,459,64713
7/10/2022,Jones,North Carolina,37103,2384,39,2423
7/10/2022,Lee,North Carolina,37105,17050,152,17202
7/10/2022,Lenoir,North Carolina,37107,16575,232,16807
7/10/2022,Lincoln,North Carolina,37109,25787,182,25969
7/10/2022,Macon,North Carolina,37113,8320,123,8443
7/10/2022,Madison,North Carolina,37115,5539,81,5620
7/10/2022,Martin,North Carolina,37117,6499,95,6594
7/10/2022,McDowell,North Carolina,37111,14572,176,14748
7/10/2022,Mecklenburg,North Carolina,37119,307760,1660,309420
7/10/2022,Mitchell,North Carolina,37121,3850,40,3890
7/10/2022,Montgomery,North Carolina,37123,7568,133,7701
7/10/2022,Moore,North Carolina,37125,26247,331,26578
7/10/2022,Nash,North Carolina,37127,27834,322,28156
7/10/2022,New Hanover,North Carolina,37129,54942,404,55346
7/10/2022,Northampton,North Carolina,37131,4707,87,4794
7/10/2022,Onslow,North Carolina,37133,55723,384,56107
7/10/2022,Orange,North Carolina,37135,31965,137,32102
7/10/2022,Pamlico,North Carolina,37137,2835,29,2864
7/10/2022,Pasquotank,North Carolina,37139,9039,129,9168
7/10/2022,Pender,North Carolina,37141,16168,131,16299
7/10/2022,Perquimans,North Carolina,37143,2940,25,2965
7/10/2022,Person,North Carolina,37145,10189,110,10299
7/10/2022,Pitt,North Carolina,37147,56473,251,56724
7/10/2022,Polk,North Carolina,37149,4128,65,4193
7/10/2022,Randolph,North Carolina,37151,37560,457,38017
7/10/2022,Richmond,North Carolina,37153,13702,195,13897
7/10/2022,Robeson,North Carolina,37155,43480,545,44025
7/10/2022,Rockingham,North Carolina,37157,23398,299,23697
7/10/2022,Rowan,North Carolina,37159,43669,596,44265
7/10/2022,Rutherford,North Carolina,37161,18370,406,18776
7/10/2022,Sampson,North Carolina,37163,19661,187,19848
7/10/2022,Scotland,North Carolina,37165,10819,134,10953
7/10/2022,Stanly,North Carolina,37167,20347,265,20612
7/10/2022,Stokes,North Carolina,37169,12061,183,12244
7/10/2022,Surry,North Carolina,37171,22473,357,22830
7/10/2022,Swain,North Carolina,37173,3959,46,4005
7/10/2022,Transylvania,North Carolina,37175,6624,77,6701
7/10/2022,Tyrrell,North Carolina,37177,1030,8,1038
7/10/2022,Union,North Carolina,37179,66850,499,67349
7/10/2022,Vance,North Carolina,37181,12796,125,12921
7/10/2022,Wake,North Carolina,37183,335727,1162,336889
7/10/2022,Warren,North Carolina,37185,4716,47,4763
7/10/2022,Washington,North Carolina,37187,3228,51,3279
7/10/2022,Watauga,North Carolina,37189,12783,69,12852
7/10/2022,Wayne,North Carolina,37191,33408,412,33820
7/10/2022,Wilkes,North Carolina,37193,18714,274,18988
7/10/2022,Wilson,North Carolina,37195,23079,323,23402
7/10/2022,Yadkin,North Carolina,37197,11877,121,11998
7/10/2022,Yancey,North Carolina,37199,5608,58,5666
7/10/2022,Adams,North Dakota,38001,623,10,633
7/10/2022,Barnes,North Dakota,38003,3102,47,3149
7/10/2022,Benson,North Dakota,38005,2028,23,2051
7/10/2022,Billings,North Dakota,38007,154,1,155
7/10/2022,Bottineau,North Dakota,38009,1682,26,1708
7/10/2022,Bowman,North Dakota,38011,865,9,874
7/10/2022,Burke,North Dakota,38013,446,3,449
7/10/2022,Burleigh,North Dakota,38015,36417,303,36720
7/10/2022,Cass,North Dakota,38017,62665,333,62998
7/10/2022,Cavalier,North Dakota,38019,868,7,875
7/10/2022,Dickey,North Dakota,38021,1523,39,1562
7/10/2022,Divide,North Dakota,38023,489,4,493
7/10/2022,Dunn,North Dakota,38025,1080,8,1088
7/10/2022,Eddy,North Dakota,38027,783,6,789
7/10/2022,Emmons,North Dakota,38029,743,18,761
7/10/2022,Foster,North Dakota,38031,1023,23,1046
7/10/2022,Golden Valley,North Dakota,38033,482,4,486
7/10/2022,Grand Forks,North Dakota,38035,23382,125,23507
7/10/2022,Grant,North Dakota,38037,470,11,481
7/10/2022,Griggs,North Dakota,38039,600,2,602
7/10/2022,Hettinger,North Dakota,38041,839,8,847
7/10/2022,Kidder,North Dakota,38043,534,13,547
7/10/2022,LaMoure,North Dakota,38045,1033,20,1053
7/10/2022,Logan,North Dakota,38047,450,12,462
7/10/2022,McHenry,North Dakota,38049,1387,31,1418
7/10/2022,McIntosh,North Dakota,38051,713,9,722
7/10/2022,McKenzie,North Dakota,38053,3362,25,3387
7/10/2022,McLean,North Dakota,38055,2810,49,2859
7/10/2022,Mercer,North Dakota,38057,2666,24,2690
7/10/2022,Morton,North Dakota,38059,11698,142,11840
7/10/2022,Mountrail,North Dakota,38061,3389,37,3426
7/10/2022,Nelson,North Dakota,38063,791,18,809
7/10/2022,Oliver,North Dakota,38065,337,5,342
7/10/2022,Pembina,North Dakota,38067,2098,16,2114
7/10/2022,Pierce,North Dakota,38069,1101,32,1133
7/10/2022,Ramsey,North Dakota,38071,3737,57,3794
7/10/2022,Ransom,North Dakota,38073,1569,28,1597
7/10/2022,Renville,North Dakota,38075,574,15,589
7/10/2022,Richland,North Dakota,38077,4225,23,4248
7/10/2022,Rolette,North Dakota,38079,6572,43,6615
7/10/2022,Sargent,North Dakota,38081,1072,9,1081
7/10/2022,Sheridan,North Dakota,38083,309,7,316
7/10/2022,Sioux,North Dakota,38085,1400,19,1419
7/10/2022,Slope,North Dakota,38087,66,0,66
7/10/2022,Stark,North Dakota,38089,12068,86,12154
7/10/2022,Steele,North Dakota,38091,393,2,395
7/10/2022,Stutsman,North Dakota,38093,7311,97,7408
7/10/2022,Towner,North Dakota,38095,670,12,682
7/10/2022,Traill,North Dakota,38097,2250,26,2276
7/10/2022,Unknown,North Dakota,,0,111,111
7/10/2022,Walsh,North Dakota,38099,3526,34,3560
7/10/2022,Ward,North Dakota,38101,21620,251,21871
7/10/2022,Wells,North Dakota,38103,1049,12,1061
7/10/2022,Williams,North Dakota,38105,10832,68,10900
7/10/2022,Rota,Northern Mariana Islands,69100,418,0,418
7/10/2022,Saipan,Northern Mariana Islands,69110,11059,35,11094
7/10/2022,Tinian,Northern Mariana Islands,69120,350,0,350
7/10/2022,Adams,Ohio,39001,7340,152,7492
7/10/2022,Allen,Ohio,39003,28574,480,29054
7/10/2022,Ashland,Ohio,39005,12564,220,12784
7/10/2022,Ashtabula,Ohio,39007,21567,433,22000
7/10/2022,Athens,Ohio,39009,16021,145,16166
7/10/2022,Auglaize,Ohio,39011,11965,189,12154
7/10/2022,Belmont,Ohio,39013,16535,315,16850
7/10/2022,Brown,Ohio,39015,11689,183,11872
7/10/2022,Butler,Ohio,39017,98519,1172,99691
7/10/2022,Carroll,Ohio,39019,5477,128,5605
7/10/2022,Champaign,Ohio,39021,9143,149,9292
7/10/2022,Clark,Ohio,39023,36753,594,37347
7/10/2022,Clermont,Ohio,39025,54941,565,55506
7/10/2022,Clinton,Ohio,39027,10809,169,10978
7/10/2022,Columbiana,Ohio,39029,25635,488,26123
7/10/2022,Coshocton,Ohio,39031,8364,161,8525
7/10/2022,Crawford,Ohio,39033,11786,216,12002
7/10/2022,Cuyahoga,Ohio,39035,292507,3844,296351
7/10/2022,Darke,Ohio,39037,12814,240,13054
7/10/2022,Defiance,Ohio,39039,10585,167,10752
7/10/2022,Delaware,Ohio,39041,48628,275,48903
7/10/2022,Erie,Ohio,39043,20825,267,21092
7/10/2022,Fairfield,Ohio,39045,40854,434,41288
7/10/2022,Fayette,Ohio,39047,8130,122,8252
7/10/2022,Franklin,Ohio,39049,314556,2638,317194
7/10/2022,Fulton,Ohio,39051,10834,181,11015
7/10/2022,Gallia,Ohio,39053,8157,128,8285
7/10/2022,Geauga,Ohio,39055,17219,269,17488
7/10/2022,Greene,Ohio,39057,40366,517,40883
7/10/2022,Guernsey,Ohio,39059,11114,156,11270
7/10/2022,Hamilton,Ohio,39061,202477,2081,204558
7/10/2022,Hancock,Ohio,39063,17908,277,18185
7/10/2022,Hardin,Ohio,39065,7370,158,7528
7/10/2022,Harrison,Ohio,39067,3418,74,3492
7/10/2022,Henry,Ohio,39069,6706,108,6814
7/10/2022,Highland,Ohio,39071,11133,184,11317
7/10/2022,Hocking,Ohio,39073,7011,125,7136
7/10/2022,Holmes,Ohio,39075,5235,184,5419
7/10/2022,Huron,Ohio,39077,15175,224,15399
7/10/2022,Jackson,Ohio,39079,9527,142,9669
7/10/2022,Jefferson,Ohio,39081,15701,324,16025
7/10/2022,Knox,Ohio,39083,14021,230,14251
7/10/2022,Lake,Ohio,39085,52314,746,53060
7/10/2022,Lawrence,Ohio,39087,19209,260,19469
7/10/2022,Licking,Ohio,39089,44426,479,44905
7/10/2022,Logan,Ohio,39091,10721,174,10895
7/10/2022,Lorain,Ohio,39093,72712,996,73708
7/10/2022,Lucas,Ohio,39095,108650,1431,110081
7/10/2022,Madison,Ohio,39097,10114,138,10252
7/10/2022,Mahoning,Ohio,39099,56888,1095,57983
7/10/2022,Marion,Ohio,39101,20944,272,21216
7/10/2022,Medina,Ohio,39103,43157,515,43672
7/10/2022,Meigs,Ohio,39105,4954,89,5043
7/10/2022,Mercer,Ohio,39107,9897,144,10041
7/10/2022,Miami,Ohio,39109,26966,485,27451
7/10/2022,Monroe,Ohio,39111,3634,82,3716
7/10/2022,Montgomery,Ohio,39113,134819,2032,136851
7/10/2022,Morgan,Ohio,39115,3488,61,3549
7/10/2022,Morrow,Ohio,39117,8154,105,8259
7/10/2022,Muskingum,Ohio,39119,26696,295,26991
7/10/2022,Noble,Ohio,39121,3373,58,3431
7/10/2022,Ottawa,Ohio,39123,9089,141,9230
7/10/2022,Paulding,Ohio,39125,4817,74,4891
7/10/2022,Perry,Ohio,39127,8724,128,8852
7/10/2022,Pickaway,Ohio,39129,18313,232,18545
7/10/2022,Pike,Ohio,39131,7902,123,8025
7/10/2022,Portage,Ohio,39133,36947,451,37398
7/10/2022,Preble,Ohio,39135,9876,200,10076
7/10/2022,Putnam,Ohio,39137,8697,158,8855
7/10/2022,Richland,Ohio,39139,33068,516,33584
7/10/2022,Ross,Ohio,39141,20436,304,20740
7/24/2022,Lawrence,Alabama,1079,8107,161,8268
7/24/2022,Lee,Alabama,1081,40893,343,41236
7/24/2022,Limestone,Alabama,1083,27141,299,27440
7/24/2022,Lowndes,Alabama,1085,2864,79,2943
7/24/2022,Macon,Alabama,1087,4348,86,4434
7/24/2022,Madison,Alabama,1089,98714,987,99701
7/24/2022,Marengo,Alabama,1091,5560,108,5668
7/24/2022,Marion,Alabama,1093,8692,153,8845
7/24/2022,Marshall,Alabama,1095,28727,396,29123
7/24/2022,Mobile,Alabama,1097,120935,1675,122610
7/24/2022,Monroe,Alabama,1099,5697,81,5778
7/24/2022,Montgomery,Alabama,1101,61746,964,62710
7/24/2022,Morgan,Alabama,1103,38956,519,39475
7/24/2022,Perry,Alabama,1105,2276,47,2323
7/24/2022,Pickens,Alabama,1107,5526,105,5631
7/24/2022,Pike,Alabama,1109,8014,136,8150
7/24/2022,Randolph,Alabama,1111,5396,75,5471
7/24/2022,Russell,Alabama,1113,11078,96,11174
7/24/2022,Shelby,Alabama,1117,65986,461,66447
7/24/2022,St. Clair,Alabama,1115,27541,420,27961
7/24/2022,Sumter,Alabama,1119,2784,52,2836
7/24/2022,Talladega,Alabama,1121,24081,380,24461
7/24/2022,Tallapoosa,Alabama,1123,12306,241,12547
7/24/2022,Tuscaloosa,Alabama,1125,60907,794,61701
7/24/2022,Walker,Alabama,1127,20082,451,20533
7/24/2022,Washington,Alabama,1129,3969,59,4028
7/24/2022,Wilcox,Alabama,1131,3146,48,3194
7/24/2022,Winston,Alabama,1133,7965,133,8098
7/24/2022,Aleutians East Borough,Alaska,2013,1175,3,1178
7/24/2022,Aleutians West Census Area,Alaska,2016,1847,1,1848
7/24/2022,Anchorage,Alaska,2020,114571,539,115110
7/24/2022,Bethel Census Area,Alaska,2050,11006,42,11048
7/24/2022,Bristol Bay plus Lake and Peninsula,Alaska,,1142,1,1143
7/24/2022,Denali Borough,Alaska,2068,1273,1,1274
7/24/2022,Dillingham Census Area,Alaska,2070,2037,12,2049
7/24/2022,Fairbanks North Star Borough,Alaska,2090,30615,147,30762
7/24/2022,Haines Borough,Alaska,2100,713,1,714
7/24/2022,Juneau City and Borough,Alaska,2110,10600,20,10620
7/24/2022,Kenai Peninsula Borough,Alaska,2122,20146,104,20250
7/24/2022,Ketchikan Gateway Borough,Alaska,2130,4825,20,4845
7/24/2022,Kodiak Island Borough,Alaska,2150,5403,12,5415
7/24/2022,Kusilvak Census Area,Alaska,2158,4365,14,4379
7/24/2022,Matanuska-Susitna Borough,Alaska,2170,37456,242,37698
7/24/2022,Nome Census Area,Alaska,2180,6384,5,6389
7/24/2022,North Slope Borough,Alaska,2185,4941,14,4955
7/24/2022,Northwest Arctic Borough,Alaska,2188,5160,14,5174
7/24/2022,Petersburg Borough,Alaska,2195,848,5,853
7/24/2022,Prince of Wales-Hyder Census Area,Alaska,2198,1642,10,1652
7/24/2022,Sitka City and Borough,Alaska,2220,3022,5,3027
7/24/2022,Skagway Municipality,Alaska,2230,503,0,503
7/24/2022,Southeast Fairbanks Census Area,Alaska,2240,2209,20,2229
7/24/2022,Unknown,Alaska,,5530,1,5531
7/24/2022,Valdez-Cordova Census Area,Alaska,2261,3349,20,3369
7/24/2022,Wrangell City and Borough,Alaska,2275,720,1,721
7/24/2022,Yakutat plus Hoonah-Angoon,Alaska,,770,5,775
7/24/2022,Yukon-Koyukuk Census Area,Alaska,2290,1576,11,1587
7/24/2022,Unknown,American Samoa,,6353,31,6384
7/24/2022,Apache,Arizona,4001,28502,619,29121
7/24/2022,Cochise,Arizona,4003,34266,583,34849
7/24/2022,Coconino,Arizona,4005,47790,484,48274
7/24/2022,Gila,Arizona,4007,18412,387,18799
7/24/2022,Graham,Arizona,4009,12531,180,12711
7/24/2022,Greenlee,Arizona,4011,2347,39,2386
7/24/2022,La Paz,Arizona,4012,5545,147,5692
7/24/2022,Maricopa,Arizona,4013,1374075,17579,1391654
7/24/2022,Mohave,Arizona,4015,61459,1490,62949
7/24/2022,Navajo,Arizona,4017,41686,917,42603
7/24/2022,Pima,Arizona,4019,276269,3919,280188
7/24/2022,Pinal,Arizona,4021,141197,1688,142885
7/24/2022,Santa Cruz,Arizona,4023,17512,232,17744
7/24/2022,Yavapai,Arizona,4025,52348,1245,53593
7/24/2022,Yuma,Arizona,4027,65241,1189,66430
7/24/2022,Arkansas,Arkansas,5001,6089,78,6167
7/24/2022,Ashley,Arkansas,5003,5479,70,5549
7/24/2022,Baxter,Arkansas,5005,9571,254,9825
7/24/2022,Benton,Arkansas,5007,70763,878,71641
7/24/2022,Boone,Arkansas,5009,10054,182,10236
7/24/2022,Bradley,Arkansas,5011,3201,53,3254
7/24/2022,Calhoun,Arkansas,5013,1041,11,1052
7/24/2022,Carroll,Arkansas,5015,6573,107,6680
7/24/2022,Chicot,Arkansas,5017,2879,59,2938
7/24/2022,Clark,Arkansas,5019,5762,83,5845
7/24/2022,Clay,Arkansas,5021,4414,95,4509
7/24/2022,Cleburne,Arkansas,5023,7003,130,7133
7/24/2022,Cleveland,Arkansas,5025,2407,36,2443
7/24/2022,Columbia,Arkansas,5027,5796,99,5895
7/24/2022,Conway,Arkansas,5029,5769,66,5835
7/24/2022,Craighead,Arkansas,5031,40524,338,40862
7/24/2022,Crawford,Arkansas,5033,16828,254,17082
7/10/2022,Sandusky,Ohio,39143,14564,240,14804
7/10/2022,Scioto,Ohio,39145,22023,259,22282
7/10/2022,Seneca,Ohio,39147,13229,234,13463
7/10/2022,Shelby,Ohio,39149,11453,188,11641
7/10/2022,Stark,Ohio,39151,84506,1730,86236
7/10/2022,Summit,Ohio,39153,121977,1736,123713
7/10/2022,Trumbull,Ohio,39155,44297,949,45246
7/10/2022,Tuscarawas,Ohio,39157,21481,508,21989
7/10/2022,Union,Ohio,39159,16832,102,16934
7/10/2022,Unknown,Ohio,,0,5,5
7/10/2022,Van Wert,Ohio,39161,6974,149,7123
7/10/2022,Vinton,Ohio,39163,3053,56,3109
7/10/2022,Warren,Ohio,39165,61922,587,62509
7/10/2022,Washington,Ohio,39167,12980,208,13188
7/10/2022,Wayne,Ohio,39169,24448,443,24891
7/10/2022,Williams,Ohio,39171,9441,165,9606
7/10/2022,Wood,Ohio,39173,33570,364,33934
7/10/2022,Wyandot,Ohio,39175,5603,105,5708
7/10/2022,Adair,Oklahoma,40001,8286,75,8361
7/10/2022,Alfalfa,Oklahoma,40003,1728,16,1744
7/10/2022,Atoka,Oklahoma,40005,4008,54,4062
7/10/2022,Beaver,Oklahoma,40007,997,11,1008
7/10/2022,Beckham,Oklahoma,40009,6080,106,6186
7/10/2022,Blaine,Oklahoma,40011,2498,44,2542
7/10/2022,Bryan,Oklahoma,40013,14107,137,14244
7/10/2022,Caddo,Oklahoma,40015,8526,172,8698
7/10/2022,Canadian,Oklahoma,40017,41476,393,41869
7/10/2022,Carter,Oklahoma,40019,14867,242,15109
7/10/2022,Cherokee,Oklahoma,40021,15117,153,15270
7/10/2022,Choctaw,Oklahoma,40023,4151,64,4215
7/10/2022,Cimarron,Oklahoma,40025,591,7,598
7/10/2022,Cleveland,Oklahoma,40027,83356,826,84182
7/10/2022,Coal,Oklahoma,40029,1720,24,1744
7/10/2022,Comanche,Oklahoma,40031,33819,401,34220
7/10/2022,Cotton,Oklahoma,40033,1480,32,1512
7/10/2022,Craig,Oklahoma,40035,4950,55,5005
7/10/2022,Creek,Oklahoma,40037,18858,338,19196
7/10/2022,Custer,Oklahoma,40039,8197,170,8367
7/10/2022,Delaware,Oklahoma,40041,11546,204,11750
7/10/2022,Dewey,Oklahoma,40043,1088,32,1120
7/10/2022,Ellis,Oklahoma,40045,838,9,847
7/10/2022,Garfield,Oklahoma,40047,15515,295,15810
7/10/2022,Garvin,Oklahoma,40049,7257,149,7406
7/10/2022,Grady,Oklahoma,40051,14153,247,14400
7/10/2022,Grant,Oklahoma,40053,1056,16,1072
7/10/2022,Greer,Oklahoma,40055,1328,37,1365
7/10/2022,Harmon,Oklahoma,40057,535,12,547
7/10/2022,Harper,Oklahoma,40059,735,12,747
7/10/2022,Haskell,Oklahoma,40061,2863,41,2904
7/10/2022,Hughes,Oklahoma,40063,2663,62,2725
7/10/2022,Jackson,Oklahoma,40065,6767,108,6875
7/10/2022,Jefferson,Oklahoma,40067,1356,26,1382
7/10/2022,Johnston,Oklahoma,40069,3105,55,3160
7/10/2022,Kay,Oklahoma,40071,12769,217,12986
7/10/2022,Kingfisher,Oklahoma,40073,4254,71,4325
7/10/2022,Kiowa,Oklahoma,40075,1996,54,2050
7/10/2022,Latimer,Oklahoma,40077,2315,35,2350
7/10/2022,Le Flore,Oklahoma,40079,12901,107,13008
7/10/2022,Lincoln,Oklahoma,40081,8181,142,8323
7/10/2022,Logan,Oklahoma,40083,11389,162,11551
7/10/2022,Love,Oklahoma,40085,3205,40,3245
7/10/2022,Major,Oklahoma,40093,2524,41,2565
7/10/2022,Marshall,Oklahoma,40095,4727,46,4773
7/10/2022,Mayes,Oklahoma,40097,10785,163,10948
7/10/2022,McClain,Oklahoma,40087,12135,138,12273
7/10/2022,McCurtain,Oklahoma,40089,8257,166,8423
7/10/2022,McIntosh,Oklahoma,40091,5004,125,5129
7/10/2022,Murray,Oklahoma,40099,4315,78,4393
7/10/2022,Muskogee,Oklahoma,40101,20673,350,21023
7/10/2022,Noble,Oklahoma,40103,3122,41,3163
7/10/2022,Nowata,Oklahoma,40105,2854,42,2896
7/10/2022,Okfuskee,Oklahoma,40107,3603,62,3665
7/10/2022,Oklahoma,Oklahoma,40109,208965,2490,211455
7/10/2022,Okmulgee,Oklahoma,40111,9896,192,10088
7/10/2022,Osage,Oklahoma,40113,11457,171,11628
7/10/2022,Ottawa,Oklahoma,40115,9640,127,9767
7/10/2022,Pawnee,Oklahoma,40117,4270,85,4355
7/10/2022,Payne,Oklahoma,40119,19285,166,19451
7/10/2022,Pittsburg,Oklahoma,40121,11166,211,11377
7/10/2022,Pontotoc,Oklahoma,40123,12634,153,12787
7/10/2022,Pottawatomie,Oklahoma,40125,21494,284,21778
7/10/2022,Pushmataha,Oklahoma,40127,2724,45,2769
7/10/2022,Roger Mills,Oklahoma,40129,916,16,932
7/10/2022,Rogers,Oklahoma,40131,26464,390,26854
7/10/2022,Seminole,Oklahoma,40133,6313,135,6448
7/10/2022,Sequoyah,Oklahoma,40135,11041,106,11147
7/10/2022,Stephens,Oklahoma,40137,11629,205,11834
7/10/2022,Texas,Oklahoma,40139,6125,55,6180
7/10/2022,Tillman,Oklahoma,40141,1565,36,1601
7/10/2022,Tulsa,Oklahoma,40143,179639,2192,181831
7/10/2022,Unknown,Oklahoma,,2629,0,2629
7/10/2022,Wagoner,Oklahoma,40145,22859,277,23136
7/10/2022,Washington,Oklahoma,40147,13163,263,13426
7/10/2022,Washita,Oklahoma,40149,2695,55,2750
7/10/2022,Woods,Oklahoma,40151,2403,38,2441
7/10/2022,Woodward,Oklahoma,40153,5316,76,5392
7/10/2022,Baker,Oregon,41001,3422,50,3472
7/10/2022,Benton,Oregon,41003,18673,73,18746
7/10/2022,Clackamas,Oregon,41005,71972,657,72629
7/10/2022,Clatsop,Oregon,41007,5398,53,5451
7/10/2022,Columbia,Oregon,41009,8882,97,8979
7/10/2022,Coos,Oregon,41011,12065,162,12227
7/10/2022,Crook,Oregon,41013,6807,84,6891
7/10/2022,Curry,Oregon,41015,3873,59,3932
7/10/2022,Deschutes,Oregon,41017,53459,297,53756
7/10/2022,Douglas,Oregon,41019,21838,410,22248
7/10/2022,Gilliam,Oregon,41021,290,6,296
7/10/2022,Grant,Oregon,41023,1851,22,1873
7/10/2022,Harney,Oregon,41025,1688,41,1729
7/10/2022,Hood River,Oregon,41027,4119,45,4164
7/10/2022,Jackson,Oregon,41029,47402,556,47958
7/10/2022,Jefferson,Oregon,41031,7798,95,7893
7/10/2022,Josephine,Oregon,41033,17810,347,18157
7/10/2022,Klamath,Oregon,41035,15490,226,15716
7/10/2022,Lake,Oregon,41037,1479,29,1508
7/10/2022,Lane,Oregon,41039,66998,572,67570
7/10/2022,Lincoln,Oregon,41041,7963,91,8054
7/10/2022,Linn,Oregon,41043,29303,279,29582
7/10/2022,Malheur,Oregon,41045,8518,108,8626
7/10/2022,Marion,Oregon,41047,76852,743,77595
7/10/2022,Morrow,Oregon,41049,3101,34,3135
7/10/2022,Multnomah,Oregon,41051,143579,1252,144831
7/10/2022,Polk,Oregon,41053,17516,139,17655
7/10/2022,Sherman,Oregon,41055,351,6,357
7/10/2022,Tillamook,Oregon,41057,4298,65,4363
7/10/2022,Umatilla,Oregon,41059,23491,229,23720
7/10/2022,Union,Oregon,41061,5302,83,5385
7/10/2022,Unknown,Oregon,,2,0,2
7/10/2022,Wallowa,Oregon,41063,1333,16,1349
7/10/2022,Wasco,Oregon,41065,5781,63,5844
7/10/2022,Washington,Oregon,41067,104448,630,105078
7/10/2022,Wheeler,Oregon,41069,254,3,257
7/10/2022,Yamhill,Oregon,41071,19843,229,20072
7/10/2022,Adams,Pennsylvania,42001,26547,381,26928
7/10/2022,Allegheny,Pennsylvania,42003,292367,3416,295783
7/10/2022,Armstrong,Pennsylvania,42005,16003,352,16355
7/10/2022,Beaver,Pennsylvania,42007,42850,762,43612
7/10/2022,Bedford,Pennsylvania,42009,11403,281,11684
7/10/2022,Berks,Pennsylvania,42011,108924,1621,110545
7/10/2022,Blair,Pennsylvania,42013,31017,636,31653
7/10/2022,Bradford,Pennsylvania,42015,17224,214,17438
7/10/2022,Bucks,Pennsylvania,42017,134971,1948,136919
7/10/2022,Butler,Pennsylvania,42019,47552,754,48306
7/10/2022,Cambria,Pennsylvania,42021,36492,744,37236
7/10/2022,Cameron,Pennsylvania,42023,873,21,894
7/10/2022,Carbon,Pennsylvania,42025,17033,305,17338
7/10/2022,Centre,Pennsylvania,42027,38051,361,38412
7/10/2022,Chester,Pennsylvania,42029,101854,1188,103042
7/10/2022,Clarion,Pennsylvania,42031,8658,209,8867
7/10/2022,Clearfield,Pennsylvania,42033,20449,355,20804
7/10/2022,Clinton,Pennsylvania,42035,9633,130,9763
7/10/2022,Columbia,Pennsylvania,42037,16359,253,16612
7/10/2022,Crawford,Pennsylvania,42039,21114,329,21443
7/10/2022,Cumberland,Pennsylvania,42041,54598,909,55507
7/10/2022,Dauphin,Pennsylvania,42043,62745,982,63727
7/10/2022,Delaware,Pennsylvania,42045,121733,1898,123631
7/10/2022,Elk,Pennsylvania,42047,7482,103,7585
7/10/2022,Erie,Pennsylvania,42049,61794,793,62587
7/10/2022,Fayette,Pennsylvania,42051,32812,686,33498
7/10/2022,Forest,Pennsylvania,42053,2303,35,2338
7/10/2022,Franklin,Pennsylvania,42055,42735,708,43443
7/10/2022,Fulton,Pennsylvania,42057,4286,66,4352
7/10/2022,Greene,Pennsylvania,42059,8925,107,9032
7/10/2022,Huntingdon,Pennsylvania,42061,12030,255,12285
7/10/2022,Indiana,Pennsylvania,42063,18578,368,18946
7/10/2022,Jefferson,Pennsylvania,42065,9517,244,9761
7/10/2022,Juniata,Pennsylvania,42067,4958,180,5138
7/10/2022,Lackawanna,Pennsylvania,42069,48421,801,49222
7/10/2022,Lancaster,Pennsylvania,42071,128658,1933,130591
7/10/2022,Lawrence,Pennsylvania,42073,19885,426,20311
7/10/2022,Lebanon,Pennsylvania,42075,38692,525,39217
7/10/2022,Lehigh,Pennsylvania,42077,96391,1274,97665
7/10/2022,Luzerne,Pennsylvania,42079,80055,1422,81477
7/10/2022,Lycoming,Pennsylvania,42081,30296,539,30835
7/10/2022,McKean,Pennsylvania,42083,8610,150,8760
7/10/2022,Mercer,Pennsylvania,42085,24615,506,25121
7/10/2022,Mifflin,Pennsylvania,42087,12790,281,13071
7/10/2022,Monroe,Pennsylvania,42089,40480,541,41021
7/10/2022,Montgomery,Pennsylvania,42091,170987,2380,173367
7/10/2022,Montour,Pennsylvania,42093,4956,94,5050
7/10/2022,Northampton,Pennsylvania,42095,86227,1127,87354
7/10/2022,Northumberland,Pennsylvania,42097,24292,547,24839
7/10/2022,Perry,Pennsylvania,42099,9200,189,9389
7/10/2022,Philadelphia,Pennsylvania,42101,337331,5178,342509
7/10/2022,Pike,Pennsylvania,42103,11209,101,11310
7/10/2022,Potter,Pennsylvania,42105,3406,93,3499
7/10/2022,Schuylkill,Pennsylvania,42107,36451,694,37145
7/10/2022,Snyder,Pennsylvania,42109,8479,159,8638
7/10/2022,Somerset,Pennsylvania,42111,19585,412,19997
7/10/2022,Sullivan,Pennsylvania,42113,1148,36,1184
7/10/2022,Susquehanna,Pennsylvania,42115,8604,115,8719
7/10/2022,Tioga,Pennsylvania,42117,8706,200,8906
7/10/2022,Union,Pennsylvania,42119,12262,155,12417
7/10/2022,Venango,Pennsylvania,42121,11911,247,12158
7/10/2022,Warren,Pennsylvania,42123,8018,215,8233
7/10/2022,Washington,Pennsylvania,42125,54673,667,55340
7/10/2022,Wayne,Pennsylvania,42127,11065,176,11241
7/10/2022,Westmoreland,Pennsylvania,42129,85229,1409,86638
7/10/2022,Wyoming,Pennsylvania,42131,5590,113,5703
7/10/2022,York,Pennsylvania,42133,126037,1522,127559
7/10/2022,Adjuntas,Puerto Rico,72001,4363,,4363
7/10/2022,Aguada,Puerto Rico,72003,9741,,9741
7/10/2022,Aguadilla,Puerto Rico,72005,11719,,11719
7/10/2022,Aguas Buenas,Puerto Rico,72007,6201,,6201
7/10/2022,Aibonito,Puerto Rico,72009,5993,,5993
7/10/2022,Anasco,Puerto Rico,72011,6102,,6102
7/10/2022,Arecibo,Puerto Rico,72013,19752,,19752
7/10/2022,Arroyo,Puerto Rico,72015,3966,,3966
7/10/2022,Barceloneta,Puerto Rico,72017,5583,,5583
7/10/2022,Barranquitas,Puerto Rico,72019,7386,,7386
7/10/2022,Bayamon,Puerto Rico,72021,51224,,51224
7/10/2022,Cabo Rojo,Puerto Rico,72023,9432,,9432
7/10/2022,Caguas,Puerto Rico,72025,33367,,33367
7/10/2022,Camuy,Puerto Rico,72027,8101,,8101
7/10/2022,Canovanas,Puerto Rico,72029,9986,,9986
7/10/2022,Carolina,Puerto Rico,72031,40851,,40851
7/10/2022,Catano,Puerto Rico,72033,5876,,5876
7/10/2022,Cayey,Puerto Rico,72035,10566,,10566
7/10/2022,Ceiba,Puerto Rico,72037,2397,,2397
7/10/2022,Ciales,Puerto Rico,72039,3988,,3988
7/10/2022,Cidra,Puerto Rico,72041,10121,,10121
7/10/2022,Coamo,Puerto Rico,72043,8669,,8669
7/10/2022,Comerio,Puerto Rico,72045,4526,,4526
7/10/2022,Corozal,Puerto Rico,72047,9297,,9297
7/10/2022,Culebra,Puerto Rico,72049,352,,352
7/10/2022,Dorado,Puerto Rico,72051,10025,,10025
7/10/2022,Fajardo,Puerto Rico,72053,7291,,7291
7/10/2022,Florida,Puerto Rico,72054,3694,,3694
7/10/2022,Guanica,Puerto Rico,72055,2559,,2559
7/10/2022,Guayama,Puerto Rico,72057,8620,,8620
7/10/2022,Guayanilla,Puerto Rico,72059,4131,,4131
7/10/2022,Guaynabo,Puerto Rico,72061,24005,,24005
7/10/2022,Gurabo,Puerto Rico,72063,11349,,11349
7/10/2022,Hatillo,Puerto Rico,72065,8442,,8442
7/10/2022,Hormigueros,Puerto Rico,72067,3566,,3566
7/10/2022,Humacao,Puerto Rico,72069,12511,,12511
7/10/2022,Isabela,Puerto Rico,72071,10650,,10650
7/10/2022,Jayuya,Puerto Rico,72073,3961,,3961
7/10/2022,Juana Diaz,Puerto Rico,72075,10579,,10579
7/10/2022,Juncos,Puerto Rico,72077,9748,,9748
7/10/2022,Lajas,Puerto Rico,72079,4830,,4830
7/10/2022,Lares,Puerto Rico,72081,7410,,7410
7/10/2022,Las Marias,Puerto Rico,72083,2163,,2163
7/10/2022,Las Piedras,Puerto Rico,72085,8843,,8843
7/10/2022,Loiza,Puerto Rico,72087,4656,,4656
7/10/2022,Luquillo,Puerto Rico,72089,4008,,4008
7/10/2022,Manati,Puerto Rico,72091,9471,,9471
7/10/2022,Maricao,Puerto Rico,72093,1092,,1092
7/10/2022,Maunabo,Puerto Rico,72095,2379,,2379
7/10/2022,Mayaguez,Puerto Rico,72097,16070,,16070
7/10/2022,Moca,Puerto Rico,72099,9906,,9906
7/10/2022,Morovis,Puerto Rico,72101,7152,,7152
7/10/2022,Naguabo,Puerto Rico,72103,5453,,5453
7/10/2022,Naranjito,Puerto Rico,72105,7555,,7555
7/10/2022,Orocovis,Puerto Rico,72107,4904,,4904
7/10/2022,Patillas,Puerto Rico,72109,3863,,3863
7/10/2022,Penuelas,Puerto Rico,72111,4176,,4176
7/10/2022,Ponce,Puerto Rico,72113,29523,,29523
7/10/2022,Quebradillas,Puerto Rico,72115,6414,,6414
7/10/2022,Rincon,Puerto Rico,72117,3312,,3312
7/10/2022,Rio Grande,Puerto Rico,72119,11220,,11220
7/10/2022,Sabana Grande,Puerto Rico,72121,4487,,4487
7/10/2022,Salinas,Puerto Rico,72123,5883,,5883
7/10/2022,San German,Puerto Rico,72125,6460,,6460
7/10/2022,San Juan,Puerto Rico,72127,82681,,82681
7/10/2022,San Lorenzo,Puerto Rico,72129,8818,,8818
7/10/2022,San Sebastian,Puerto Rico,72131,10338,,10338
7/10/2022,Santa Isabel,Puerto Rico,72133,4798,,4798
7/10/2022,Toa Alta,Puerto Rico,72135,17483,,17483
7/10/2022,Toa Baja,Puerto Rico,72137,18976,,18976
7/10/2022,Trujillo Alto,Puerto Rico,72139,15060,,15060
7/10/2022,Unknown,Puerto Rico,,28635,4629,33264
7/10/2022,Utuado,Puerto Rico,72141,5894,,5894
7/10/2022,Vega Alta,Puerto Rico,72143,9397,,9397
7/10/2022,Vega Baja,Puerto Rico,72145,15457,,15457
7/10/2022,Vieques,Puerto Rico,72147,1327,,1327
7/10/2022,Villalba,Puerto Rico,72149,5761,,5761
7/10/2022,Yabucoa,Puerto Rico,72151,7641,,7641
7/10/2022,Yauco,Puerto Rico,72153,7985,,7985
7/10/2022,Bristol,Rhode Island,44001,15606,177,15783
7/10/2022,Kent,Rhode Island,44003,55169,519,55688
7/10/2022,Newport,Rhode Island,44005,23152,95,23247
7/10/2022,Providence,Rhode Island,44007,243956,2576,246532
7/10/2022,Unknown,Rhode Island,,29124,7,29131
7/10/2022,Washington,Rhode Island,44009,37597,241,37838
7/10/2022,Abbeville,South Carolina,45001,6812,69,6881
7/10/2022,Aiken,South Carolina,45003,43814,440,44254
7/10/2022,Allendale,South Carolina,45005,2148,24,2172
7/10/2022,Anderson,South Carolina,45007,59973,1004,60977
7/10/2022,Bamberg,South Carolina,45009,3636,75,3711
7/10/2022,Barnwell,South Carolina,45011,6012,103,6115
7/10/2022,Beaufort,South Carolina,45013,46107,384,46491
7/10/2022,Berkeley,South Carolina,45015,55815,452,56267
7/10/2022,Calhoun,South Carolina,45017,2935,61,2996
7/10/2022,Charleston,South Carolina,45019,121016,959,121975
7/10/2022,Cherokee,South Carolina,45021,15355,322,15677
7/10/2022,Chester,South Carolina,45023,10529,154,10683
7/10/2022,Chesterfield,South Carolina,45025,12632,195,12827
7/10/2022,Clarendon,South Carolina,45027,9313,160,9473
7/10/2022,Colleton,South Carolina,45029,9366,222,9588
7/10/2022,Darlington,South Carolina,45031,19801,314,20115
7/10/2022,Dillon,South Carolina,45033,10189,145,10334
7/10/2022,Dorchester,South Carolina,45035,59931,505,60436
7/10/2022,Edgefield,South Carolina,45037,7063,71,7134
7/10/2022,Fairfield,South Carolina,45039,6320,110,6430
7/10/2022,Florence,South Carolina,45041,43916,639,44555
7/10/2022,Georgetown,South Carolina,45043,16791,229,17020
7/10/2022,Greenville,South Carolina,45045,180251,2022,182273
7/10/2022,Greenwood,South Carolina,45047,23030,309,23339
7/10/2022,Hampton,South Carolina,45049,5203,86,5289
7/10/2022,Horry,South Carolina,45051,103695,1172,104867
7/10/2022,Jasper,South Carolina,45053,6201,93,6294
7/10/2022,Kershaw,South Carolina,45055,23013,263,23276
7/10/2022,Lancaster,South Carolina,45057,26803,282,27085
7/10/2022,Laurens,South Carolina,45059,19268,297,19565
7/10/2022,Lee,South Carolina,45061,4511,96,4607
7/10/2022,Lexington,South Carolina,45063,102039,888,102927
7/10/2022,Marion,South Carolina,45067,9154,165,9319
7/10/2022,Marlboro,South Carolina,45069,8349,105,8454
7/10/2022,McCormick,South Carolina,45065,2312,40,2352
7/10/2022,Newberry,South Carolina,45071,13848,200,14048
7/10/2022,Oconee,South Carolina,45073,25240,348,25588
7/10/2022,Orangeburg,South Carolina,45075,24765,424,25189
7/10/2022,Pickens,South Carolina,45077,47599,638,48237
7/10/2022,Richland,South Carolina,45079,132842,958,133800
7/10/2022,Saluda,South Carolina,45081,4045,78,4123
7/10/2022,Spartanburg,South Carolina,45083,98905,1553,100458
7/10/2022,Sumter,South Carolina,45085,30171,403,30574
7/10/2022,Union,South Carolina,45087,8059,150,8209
7/10/2022,Williamsburg,South Carolina,45089,8929,146,9075
7/10/2022,York,South Carolina,45091,82433,690,83123
7/10/2022,Aurora,South Dakota,46003,818,17,835
7/10/2022,Beadle,South Dakota,46005,4779,60,4839
7/10/2022,Bennett,South Dakota,46007,807,14,821
7/10/2022,Bon Homme,South Dakota,46009,2318,39,2357
7/10/2022,Brookings,South Dakota,46011,8421,56,8477
7/10/2022,Brown,South Dakota,46013,10561,121,10682
7/10/2022,Brule,South Dakota,46015,1467,22,1489
7/10/2022,Buffalo,South Dakota,46017,622,18,640
7/10/2022,Butte,South Dakota,46019,2847,46,2893
7/10/2022,Campbell,South Dakota,46021,273,7,280
7/10/2022,Charles Mix,South Dakota,46023,3002,35,3037
7/10/2022,Clark,South Dakota,46025,822,10,832
7/10/2022,Clay,South Dakota,46027,3573,22,3595
7/10/2022,Codington,South Dakota,46029,8785,101,8886
7/10/2022,Corson,South Dakota,46031,1082,17,1099
7/10/2022,Custer,South Dakota,46033,2182,26,2208
7/10/2022,Davison,South Dakota,46035,6045,81,6126
7/10/2022,Day,South Dakota,46037,1318,35,1353
7/10/2022,Deuel,South Dakota,46039,1064,12,1076
7/10/2022,Dewey,South Dakota,46041,3142,44,3186
7/10/2022,Douglas,South Dakota,46043,699,16,715
7/10/2022,Edmunds,South Dakota,46045,968,16,984
7/10/2022,Fall River,South Dakota,46047,1989,39,2028
7/10/2022,Faulk,South Dakota,46049,590,17,607
7/10/2022,Grant,South Dakota,46051,2103,51,2154
7/10/2022,Gregory,South Dakota,46053,1081,34,1115
7/10/2022,Haakon,South Dakota,46055,470,12,482
7/10/2022,Hamlin,South Dakota,46057,1596,41,1637
7/10/2022,Hand,South Dakota,46059,584,13,597
7/10/2022,Hanson,South Dakota,46061,667,6,673
7/10/2022,Harding,South Dakota,46063,209,3,212
7/10/2022,Hughes,South Dakota,46065,4453,58,4511
7/10/2022,Hutchinson,South Dakota,46067,1798,36,1834
7/10/2022,Hyde,South Dakota,46069,313,8,321
7/10/2022,Jackson,South Dakota,46071,644,21,665
7/10/2022,Jerauld,South Dakota,46073,421,20,441
7/10/2022,Jones,South Dakota,46075,181,2,183
7/10/2022,Kingsbury,South Dakota,46077,1364,22,1386
7/10/2022,Lake,South Dakota,46079,2379,28,2407
7/10/2022,Lawrence,South Dakota,46081,6892,83,6975
7/10/2022,Lincoln,South Dakota,46083,15962,102,16064
7/10/2022,Lyman,South Dakota,46085,1235,12,1247
7/10/2022,Marshall,South Dakota,46091,808,13,821
7/10/2022,McCook,South Dakota,46087,1361,31,1392
7/10/2022,McPherson,South Dakota,46089,438,9,447
7/10/2022,Meade,South Dakota,46093,7341,64,7405
7/10/2022,Mellette,South Dakota,46095,529,8,537
7/10/2022,Miner,South Dakota,46097,475,13,488
7/10/2022,Minnehaha,South Dakota,46099,58757,525,59282
7/10/2022,Moody,South Dakota,46101,1434,28,1462
7/10/2022,Oglala Lakota,South Dakota,46102,4048,61,4109
7/10/2022,Pennington,South Dakota,46103,34428,347,34775
7/10/2022,Perkins,South Dakota,46105,720,18,738
7/10/2022,Potter,South Dakota,46107,707,7,714
7/10/2022,Roberts,South Dakota,46109,2474,53,2527
7/10/2022,Sanborn,South Dakota,46111,598,7,605
7/10/2022,Spink,South Dakota,46115,1453,36,1489
7/10/2022,Stanley,South Dakota,46117,650,7,657
7/10/2022,Sully,South Dakota,46119,249,3,252
7/10/2022,Todd,South Dakota,46121,3025,52,3077
7/10/2022,Tripp,South Dakota,46123,1440,25,1465
7/10/2022,Turner,South Dakota,46125,2016,62,2078
7/10/2022,Union,South Dakota,46127,4079,52,4131
7/10/2022,Walworth,South Dakota,46129,1366,26,1392
7/10/2022,Yankton,South Dakota,46135,6112,59,6171
7/10/2022,Ziebach,South Dakota,46137,671,11,682
7/10/2022,Anderson,Tennessee,47001,23091,349,23440
7/10/2022,Bedford,Tennessee,47003,15401,239,15640
7/10/2022,Benton,Tennessee,47005,4734,94,4828
7/10/2022,Bledsoe,Tennessee,47007,4747,61,4808
7/10/2022,Blount,Tennessee,47009,40712,451,41163
7/10/2022,Bradley,Tennessee,47011,34263,423,34686
7/10/2022,Campbell,Tennessee,47013,12780,170,12950
7/10/2022,Cannon,Tennessee,47015,4386,68,4454
7/10/2022,Carroll,Tennessee,47017,9354,158,9512
7/10/2022,Carter,Tennessee,47019,17130,342,17472
7/10/2022,Cheatham,Tennessee,47021,11398,125,11523
7/10/2022,Chester,Tennessee,47023,6053,99,6152
7/10/2022,Claiborne,Tennessee,47025,9360,182,9542
7/10/2022,Clay,Tennessee,47027,2347,52,2399
7/10/2022,Cocke,Tennessee,47029,12024,224,12248
7/10/2022,Coffee,Tennessee,47031,17593,273,17866
7/10/2022,Crockett,Tennessee,47033,5366,88,5454
7/10/2022,Cumberland,Tennessee,47035,16695,329,17024
7/10/2022,Davidson,Tennessee,47037,223730,1708,225438
7/10/2022,Decatur,Tennessee,47039,3865,71,3936
7/10/2022,DeKalb,Tennessee,47041,6499,102,6601
7/10/2022,Dickson,Tennessee,47043,16555,245,16800
7/10/2022,Dyer,Tennessee,47045,13358,212,13570
7/10/2022,Fayette,Tennessee,47047,12197,189,12386
7/10/2022,Fentress,Tennessee,47049,5819,129,5948
7/10/2022,Franklin,Tennessee,47051,13313,187,13500
7/10/2022,Gibson,Tennessee,47053,18127,264,18391
7/10/2022,Giles,Tennessee,47055,9750,196,9946
7/10/2022,Grainger,Tennessee,47057,6975,111,7086
7/10/2022,Greene,Tennessee,47059,22773,379,23152
7/10/2022,Grundy,Tennessee,47061,4101,75,4176
7/10/2022,Hamblen,Tennessee,47063,20402,364,20766
7/10/2022,Hamilton,Tennessee,47065,106460,1180,107640
7/10/2022,Hancock,Tennessee,47067,2072,37,2109
7/10/2022,Hardeman,Tennessee,47069,7977,118,8095
7/10/2022,Hardin,Tennessee,47071,9180,154,9334
7/10/2022,Hawkins,Tennessee,47073,17190,330,17520
7/10/2022,Haywood,Tennessee,47075,6463,103,6566
7/10/2022,Henderson,Tennessee,47077,9386,164,9550
7/10/2022,Henry,Tennessee,47079,8572,165,8737
7/10/2022,Hickman,Tennessee,47081,7115,111,7226
7/10/2022,Houston,Tennessee,47083,2737,62,2799
7/10/2022,Humphreys,Tennessee,47085,5014,77,5091
7/10/2022,Jackson,Tennessee,47087,3303,63,3366
7/10/2022,Jefferson,Tennessee,47089,16339,277,16616
7/10/2022,Johnson,Tennessee,47091,5338,95,5433
7/10/2022,Knox,Tennessee,47093,134666,1418,136084
7/10/2022,Lake,Tennessee,47095,2823,44,2867
7/10/2022,Lauderdale,Tennessee,47097,8077,107,8184
7/10/2022,Lawrence,Tennessee,47099,14652,206,14858
7/10/2022,Lewis,Tennessee,47101,3647,61,3708
7/10/2022,Lincoln,Tennessee,47103,10307,175,10482
7/10/2022,Loudon,Tennessee,47105,15186,193,15379
7/10/2022,Macon,Tennessee,47111,8739,146,8885
7/10/2022,Madison,Tennessee,47113,31911,431,32342
7/10/2022,Marion,Tennessee,47115,9147,132,9279
7/10/2022,Marshall,Tennessee,47117,10718,125,10843
7/10/2022,Maury,Tennessee,47119,30333,353,30686
7/10/2022,McMinn,Tennessee,47107,17195,265,17460
7/10/2022,McNairy,Tennessee,47109,8053,126,8179
7/10/2022,Meigs,Tennessee,47121,3495,59,3554
7/10/2022,Monroe,Tennessee,47123,15119,249,15368
7/10/2022,Montgomery,Tennessee,47125,52692,589,53281
7/10/2022,Moore,Tennessee,47127,2297,40,2337
7/10/2022,Morgan,Tennessee,47129,6343,87,6430
7/10/2022,Obion,Tennessee,47131,11266,202,11468
7/10/2022,Overton,Tennessee,47133,7373,126,7499
7/10/2022,Perry,Tennessee,47135,2412,56,2468
7/10/2022,Pickett,Tennessee,47137,1834,36,1870
7/10/2022,Polk,Tennessee,47139,4876,80,4956
7/10/2022,Putnam,Tennessee,47141,25889,306,26195
7/10/2022,Rhea,Tennessee,47143,10251,161,10412
7/10/2022,Roane,Tennessee,47145,16354,236,16590
7/10/2022,Robertson,Tennessee,47147,22356,310,22666
7/10/2022,Rutherford,Tennessee,47149,100652,917,101569
7/10/2022,Scott,Tennessee,47151,9416,121,9537
7/10/2022,Sequatchie,Tennessee,47153,4366,70,4436
7/10/2022,Sevier,Tennessee,47155,31461,424,31885
7/10/2022,Shelby,Tennessee,47157,259145,3371,262516
7/10/2022,Smith,Tennessee,47159,6360,87,6447
7/10/2022,Stewart,Tennessee,47161,3375,63,3438
7/10/2022,Sullivan,Tennessee,47163,47986,732,48718
7/10/2022,Sumner,Tennessee,47165,55924,740,56664
7/10/2022,Tipton,Tennessee,47167,18706,237,18943
7/10/2022,Trousdale,Tennessee,47169,4315,46,4361
7/10/2022,Unicoi,Tennessee,47171,5370,97,5467
7/10/2022,Union,Tennessee,47173,5674,78,5752
7/10/2022,Unknown,Tennessee,,24267,296,24563
7/10/2022,Van Buren,Tennessee,47175,1889,48,1937
7/10/2022,Warren,Tennessee,47177,13408,181,13589
7/10/2022,Washington,Tennessee,47179,40487,503,40990
7/10/2022,Wayne,Tennessee,47181,5828,72,5900
7/10/2022,Weakley,Tennessee,47183,9913,158,10071
7/10/2022,White,Tennessee,47185,8475,130,8605
7/10/2022,Williamson,Tennessee,47187,66447,415,66862
7/10/2022,Wilson,Tennessee,47189,44003,497,44500
7/10/2022,Anderson,Texas,48001,9863,240,10103
7/10/2022,Andrews,Texas,48003,3959,72,4031
7/10/2022,Angelina,Texas,48005,15778,484,16262
7/10/2022,Aransas,Texas,48007,4547,88,4635
7/10/2022,Archer,Texas,48009,2330,28,2358
7/10/2022,Armstrong,Texas,48011,582,10,592
7/10/2022,Atascosa,Texas,48013,14176,232,14408
7/10/2022,Austin,Texas,48015,6190,75,6265
7/10/2022,Bailey,Texas,48017,1646,39,1685
7/10/2022,Bandera,Texas,48019,3823,77,3900
7/10/2022,Bastrop,Texas,48021,23358,240,23598
7/10/2022,Baylor,Texas,48023,831,32,863
7/10/2022,Bee,Texas,48025,8805,154,8959
7/10/2022,Bell,Texas,48027,71291,912,72203
7/10/2022,Bexar,Texas,48029,602622,6184,608806
7/10/2022,Blanco,Texas,48031,2752,34,2786
7/10/2022,Borden,Texas,48033,103,2,105
7/10/2022,Bosque,Texas,48035,4241,70,4311
7/10/2022,Bowie,Texas,48037,21047,436,21483
7/10/2022,Brazoria,Texas,48039,101684,989,102673
7/10/2022,Brazos,Texas,48041,64690,418,65108
7/10/2022,Brewster,Texas,48043,1131,31,1162
7/10/2022,Briscoe,Texas,48045,478,8,486
7/10/2022,Brooks,Texas,48047,1738,52,1790
7/10/2022,Brown,Texas,48049,12424,253,12677
7/10/2022,Burleson,Texas,48051,5215,66,5281
7/10/2022,Burnet,Texas,48053,11708,172,11880
7/10/2022,Caldwell,Texas,48055,15349,176,15525
7/10/2022,Calhoun,Texas,48057,6058,51,6109
7/10/2022,Callahan,Texas,48059,3059,72,3131
7/10/2022,Cameron,Texas,48061,114305,2046,116351
7/10/2022,Camp,Texas,48063,2946,75,3021
7/10/2022,Carson,Texas,48065,1567,37,1604
7/10/2022,Cass,Texas,48067,7507,197,7704
7/10/2022,Castro,Texas,48069,2364,47,2411
7/10/2022,Chambers,Texas,48071,12579,112,12691
7/10/2022,Cherokee,Texas,48073,8212,254,8466
7/10/2022,Childress,Texas,48075,2704,34,2738
7/10/2022,Clay,Texas,48077,2249,36,2285
7/10/2022,Cochran,Texas,48079,898,23,921
7/10/2022,Coke,Texas,48081,916,20,936
7/10/2022,Coleman,Texas,48083,1687,71,1758
7/10/2022,Collin,Texas,48085,231055,1520,232575
7/10/2022,Collingsworth,Texas,48087,730,16,746
7/10/2022,Colorado,Texas,48089,3981,66,4047
7/10/2022,Comal,Texas,48091,37172,559,37731
7/10/2022,Comanche,Texas,48093,3772,78,3850
7/10/2022,Concho,Texas,48095,1147,11,1158
7/10/2022,Cooke,Texas,48097,7602,134,7736
7/10/2022,Coryell,Texas,48099,18376,214,18590
7/10/2022,Cottle,Texas,48101,332,9,341
7/10/2022,Crane,Texas,48103,1330,24,1354
7/10/2022,Crockett,Texas,48105,1130,20,1150
7/10/2022,Crosby,Texas,48107,1935,45,1980
7/10/2022,Culberson,Texas,48109,518,14,532
7/10/2022,Dallam,Texas,48111,2195,40,2235
7/10/2022,Dallas,Texas,48113,602170,6798,608968
7/10/2022,Dawson,Texas,48115,3036,95,3131
7/10/2022,Deaf Smith,Texas,48117,4938,114,5052
7/10/2022,Delta,Texas,48119,1871,25,1896
7/10/2022,Denton,Texas,48121,191010,1361,192371
7/10/2022,DeWitt,Texas,48123,6691,100,6791
7/10/2022,Dickens,Texas,48125,468,16,484
7/10/2022,Dimmit,Texas,48127,5914,51,5965
7/10/2022,Donley,Texas,48129,1169,26,1195
7/10/2022,Duval,Texas,48131,3620,70,3690
7/10/2022,Eastland,Texas,48133,2880,113,2993
7/10/2022,Ector,Texas,48135,38348,707,39055
7/10/2022,Edwards,Texas,48137,498,11,509
7/10/2022,Ellis,Texas,48139,51073,585,51658
7/10/2022,El Paso,Texas,48141,221395,3753,225148
7/10/2022,Erath,Texas,48143,8967,124,9091
7/10/2022,Falls,Texas,48145,3905,67,3972
7/10/2022,Fannin,Texas,48147,7102,183,7285
7/10/2022,Fayette,Texas,48149,4968,109,5077
7/10/2022,Fisher,Texas,48151,620,24,644
7/10/2022,Floyd,Texas,48153,2005,48,2053
7/10/2022,Foard,Texas,48155,220,11,231
7/10/2022,Fort Bend,Texas,48157,210683,1271,211954
7/10/2022,Franklin,Texas,48159,2281,44,2325
7/10/2022,Freestone,Texas,48161,3956,82,4038
7/10/2022,Frio,Texas,48163,6157,94,6251
7/10/2022,Gaines,Texas,48165,2232,83,2315
7/10/2022,Galveston,Texas,48167,104966,860,105826
7/10/2022,Garza,Texas,48169,1313,28,1341
7/10/2022,Gillespie,Texas,48171,5640,109,5749
7/10/2022,Glasscock,Texas,48173,212,3,215
7/10/2022,Goliad,Texas,48175,1288,32,1320
7/10/2022,Gonzales,Texas,48177,4877,100,4977
7/10/2022,Gray,Texas,48179,6328,126,6454
7/10/2022,Grayson,Texas,48181,27965,644,28609
7/10/2022,Gregg,Texas,48183,23884,694,24578
7/10/2022,Grimes,Texas,48185,8954,125,9079
7/10/2022,Guadalupe,Texas,48187,40418,401,40819
7/10/2022,Hale,Texas,48189,6801,245,7046
7/10/2022,Hall,Texas,48191,1130,24,1154
7/10/2022,Hamilton,Texas,48193,1988,33,2021
7/10/2022,Hansford,Texas,48195,1999,29,2028
7/10/2022,Hardeman,Texas,48197,566,19,585
7/10/2022,Hardin,Texas,48199,12435,251,12686
7/10/2022,Harris,Texas,48201,1113353,11052,1124405
7/10/2022,Harrison,Texas,48203,13911,227,14138
7/10/2022,Hartley,Texas,48205,1385,3,1388
7/10/2022,Haskell,Texas,48207,919,39,958
7/10/2022,Hays,Texas,48209,66793,517,67310
7/10/2022,Hemphill,Texas,48211,1265,7,1272
7/10/2022,Henderson,Texas,48213,15860,427,16287
7/10/2022,Hidalgo,Texas,48215,222565,3929,226494
7/10/2022,Hill,Texas,48217,9153,192,9345
7/10/2022,Hockley,Texas,48219,7995,163,8158
7/10/2022,Hood,Texas,48221,13767,278,14045
7/10/2022,Hopkins,Texas,48223,7422,181,7603
7/10/2022,Houston,Texas,48225,4348,113,4461
7/10/2022,Howard,Texas,48227,7055,184,7239
7/10/2022,Hudspeth,Texas,48229,1081,18,1099
7/10/2022,Hunt,Texas,48231,16395,365,16760
7/10/2022,Hutchinson,Texas,48233,6920,136,7056
7/10/2022,Irion,Texas,48235,489,3,492
7/10/2022,Jack,Texas,48237,1562,28,1590
7/10/2022,Jackson,Texas,48239,3361,59,3420
7/10/2022,Jasper,Texas,48241,6507,187,6694
7/10/2022,Jeff Davis,Texas,48243,238,9,247
7/10/2022,Jefferson,Texas,48245,53866,853,54719
7/10/2022,Jim Hogg,Texas,48247,2949,22,2971
7/10/2022,Jim Wells,Texas,48249,12142,211,12353
7/10/2022,Johnson,Texas,48251,45447,742,46189
7/10/2022,Jones,Texas,48253,4763,93,4856
7/10/2022,Karnes,Texas,48255,6118,71,6189
7/10/2022,Kaufman,Texas,48257,37154,535,37689
7/10/2022,Kendall,Texas,48259,8791,123,8914
7/10/2022,Kenedy,Texas,48261,86,2,88
7/10/2022,Kent,Texas,48263,211,4,215
7/10/2022,Kerr,Texas,48265,10071,185,10256
7/10/2022,Kimble,Texas,48267,756,15,771
7/10/2022,King,Texas,48269,52,0,52
7/10/2022,Kinney,Texas,48271,767,11,778
7/10/2022,Kleberg,Texas,48273,7853,147,8000
7/10/2022,Knox,Texas,48275,532,26,558
7/10/2022,Lamar,Texas,48277,12851,257,13108
7/10/2022,Lamb,Texas,48279,4500,122,4622
7/10/2022,Lampasas,Texas,48281,5753,93,5846
7/10/2022,La Salle,Texas,48283,2460,49,2509
7/10/2022,Lavaca,Texas,48285,4402,121,4523
7/10/2022,Lee,Texas,48287,4458,60,4518
7/10/2022,Leon,Texas,48289,3825,93,3918
7/10/2022,Liberty,Texas,48291,19250,405,19655
7/10/2022,Limestone,Texas,48293,5276,124,5400
7/10/2022,Lipscomb,Texas,48295,736,17,753
7/10/2022,Live Oak,Texas,48297,2203,42,2245
7/10/2022,Llano,Texas,48299,4217,97,4314
7/10/2022,Loving,Texas,48301,261,1,262
7/10/2022,Lubbock,Texas,48303,96768,1338,98106
7/10/2022,Lynn,Texas,48305,1572,38,1610
7/10/2022,Madison,Texas,48313,3874,56,3930
7/10/2022,Marion,Texas,48315,1737,60,1797
7/10/2022,Martin,Texas,48317,1251,26,1277
7/10/2022,Mason,Texas,48319,817,12,829
7/10/2022,Matagorda,Texas,48321,8976,176,9152
7/10/2022,Maverick,Texas,48323,21490,471,21961
7/10/2022,McCulloch,Texas,48307,1378,47,1425
7/10/2022,McLennan,Texas,48309,63632,907,64539
7/10/2022,McMullen,Texas,48311,172,9,181
7/10/2022,Medina,Texas,48325,10698,200,10898
7/10/2022,Menard,Texas,48327,546,12,558
7/10/2022,Midland,Texas,48329,42054,497,42551
7/10/2022,Milam,Texas,48331,5149,102,5251
7/10/2022,Mills,Texas,48333,1480,37,1517
7/10/2022,Mitchell,Texas,48335,1911,49,1960
7/10/2022,Montague,Texas,48337,4791,129,4920
7/10/2022,Montgomery,Texas,48339,152007,1303,153310
7/10/2022,Moore,Texas,48341,5858,111,5969
7/10/2022,Morris,Texas,48343,2597,73,2670
7/10/2022,Motley,Texas,48345,293,13,306
7/10/2022,Nacogdoches,Texas,48347,12857,259,13116
7/10/2022,Navarro,Texas,48349,12842,223,13065
7/10/2022,Newton,Texas,48351,1457,62,1519
7/10/2022,Nolan,Texas,48353,3153,99,3252
7/10/2022,Nueces,Texas,48355,99140,1509,100649
7/10/2022,Ochiltree,Texas,48357,2474,48,2522
7/10/2022,Oldham,Texas,48359,579,6,585
7/10/2022,Orange,Texas,48361,15461,360,15821
7/10/2022,Palo Pinto,Texas,48363,7195,154,7349
7/10/2022,Panola,Texas,48365,4801,129,4930
7/10/2022,Parker,Texas,48367,35997,453,36450
7/10/2022,Parmer,Texas,48369,2438,52,2490
7/10/2022,Pecos,Texas,48371,2887,71,2958
7/10/2022,Pending County Assignment,Texas,,65,0,65
7/10/2022,Polk,Texas,48373,8207,249,8456
7/10/2022,Potter,Texas,48375,36976,744,37720
7/10/2022,Presidio,Texas,48377,1029,38,1067
7/10/2022,Rains,Texas,48379,1903,59,1962
7/10/2022,Randall,Texas,48381,39413,518,39931
7/10/2022,Reagan,Texas,48383,892,14,906
7/10/2022,Real,Texas,48385,871,25,896
7/10/2022,Red River,Texas,48387,2370,67,2437
7/10/2022,Reeves,Texas,48389,4837,74,4911
7/10/2022,Refugio,Texas,48391,1877,37,1914
7/10/2022,Roberts,Texas,48393,179,2,181
7/10/2022,Robertson,Texas,48395,4730,77,4807
7/10/2022,Rockwall,Texas,48397,27975,267,28242
7/10/2022,Runnels,Texas,48399,2462,67,2529
7/10/2022,Rusk,Texas,48401,11097,233,11330
7/10/2022,Sabine,Texas,48403,1327,89,1416
7/10/2022,San Augustine,Texas,48405,1114,44,1158
7/10/2022,San Jacinto,Texas,48407,5866,102,5968
7/10/2022,San Patricio,Texas,48409,11945,341,12286
7/10/2022,San Saba,Texas,48411,1274,35,1309
7/10/2022,Schleicher,Texas,48413,538,9,547
7/10/2022,Scurry,Texas,48415,5116,104,5220
7/10/2022,Shackelford,Texas,48417,710,12,722
7/10/2022,Shelby,Texas,48419,4600,134,4734
7/10/2022,Sherman,Texas,48421,504,16,520
7/10/2022,Smith,Texas,48423,47519,974,48493
7/10/2022,Somervell,Texas,48425,2131,36,2167
7/10/2022,Starr,Texas,48427,20987,366,21353
7/10/2022,Stephens,Texas,48429,1913,46,1959
7/10/2022,Sterling,Texas,48431,255,7,262
7/10/2022,Stonewall,Texas,48433,365,7,372
7/10/2022,Sutton,Texas,48435,852,12,864
7/10/2022,Swisher,Texas,48437,2349,34,2383
7/10/2022,Tarrant,Texas,48439,591733,5965,597698
7/10/2022,Taylor,Texas,48441,36431,732,37163
7/10/2022,Terrell,Texas,48443,125,3,128
7/10/2022,Terry,Texas,48445,2818,85,2903
7/10/2022,Throckmorton,Texas,48447,275,8,283
7/10/2022,Titus,Texas,48449,8860,129,8989
7/10/2022,Tom Green,Texas,48451,42703,554,43257
7/10/2022,Travis,Texas,48453,249325,1749,251074
7/10/2022,Trinity,Texas,48455,2810,73,2883
7/10/2022,Tyler,Texas,48457,3808,88,3896
7/10/2022,Upshur,Texas,48459,8093,186,8279
7/10/2022,Upton,Texas,48461,848,18,866
7/10/2022,Uvalde,Texas,48463,10806,145,10951
7/10/2022,Val Verde,Texas,48465,14743,304,15047
7/10/2022,Van Zandt,Texas,48467,10725,284,11009
7/10/2022,Victoria,Texas,48469,19886,412,20298
7/10/2022,Walker,Texas,48471,19966,213,20179
7/10/2022,Waller,Texas,48473,10234,108,10342
7/10/2022,Ward,Texas,48475,2900,44,2944
7/10/2022,Washington,Texas,48477,9611,148,9759
7/10/2022,Webb,Texas,48479,100371,1039,101410
7/10/2022,Wharton,Texas,48481,9748,218,9966
7/10/2022,Wheeler,Texas,48483,1213,23,1236
7/10/2022,Wichita,Texas,48485,34749,684,35433
7/10/2022,Wilbarger,Texas,48487,3615,88,3703
7/10/2022,Willacy,Texas,48489,7581,133,7714
7/10/2022,Williamson,Texas,48491,145771,937,146708
7/10/2022,Wilson,Texas,48493,11454,159,11613
7/10/2022,Winkler,Texas,48495,1880,34,1914
7/10/2022,Wise,Texas,48497,17505,273,17778
7/10/2022,Wood,Texas,48499,8265,289,8554
7/10/2022,Yoakum,Texas,48501,1344,42,1386
7/10/2022,Young,Texas,48503,4147,95,4242
7/10/2022,Zapata,Texas,48505,3869,55,3924
7/10/2022,Zavala,Texas,48507,4165,68,4233
7/10/2022,Beaver,Utah,49001,1658,16,1674
7/10/2022,Box Elder,Utah,49003,14665,125,14790
7/10/2022,Cache,Utah,49005,38565,111,38676
7/10/2022,Carbon,Utah,49007,5476,47,5523
7/10/2022,Daggett,Utah,49009,161,0,161
7/10/2022,Davis,Utah,49011,107319,415,107734
7/10/2022,Duchesne,Utah,49013,4584,27,4611
7/10/2022,Emery,Utah,49015,2594,28,2622
7/10/2022,Garfield,Utah,49017,971,16,987
7/10/2022,Grand,Utah,49019,2542,6,2548
7/10/2022,Iron,Utah,49021,15252,93,15345
7/10/2022,Juab,Utah,49023,2978,25,3003
7/10/2022,Kane,Utah,49025,1446,15,1461
7/10/2022,Millard,Utah,49027,3376,35,3411
7/10/2022,Morgan,Utah,49029,3016,15,3031
7/10/2022,Piute,Utah,49031,315,7,322
7/10/2022,Rich,Utah,49033,352,0,352
7/10/2022,Salt Lake,Utah,49035,370406,1669,372075
7/10/2022,San Juan,Utah,49037,4265,49,4314
7/10/2022,Sanpete,Utah,49039,8530,56,8586
7/10/2022,Sevier,Utah,49041,5573,30,5603
7/10/2022,Summit,Utah,49043,14692,27,14719
7/10/2022,Tooele,Utah,49045,22684,106,22790
7/10/2022,Uintah,Utah,49047,8447,73,8520
7/10/2022,Unknown,Utah,,4298,92,4390
7/10/2022,Utah,Utah,49049,211057,810,211867
7/10/2022,Wasatch,Utah,49051,11250,36,11286
7/10/2022,Washington,Utah,49053,46926,467,47393
7/10/2022,Wayne,Utah,49055,467,0,467
7/10/2022,Weber,Utah,49057,76147,451,76598
7/10/2022,Addison,Vermont,50001,6249,21,6270
7/10/2022,Bennington,Vermont,50003,10888,73,10961
7/10/2022,Caledonia,Vermont,50005,6122,30,6152
7/10/2022,Chittenden,Vermont,50007,36443,181,36624
7/10/2022,Essex,Vermont,50009,1348,3,1351
7/10/2022,Franklin,Vermont,50011,10629,68,10697
7/10/2022,Grand Isle,Vermont,50013,1178,6,1184
7/10/2022,Lamoille,Vermont,50015,4083,17,4100
7/10/2022,Orange,Vermont,50017,4650,14,4664
7/10/2022,Orleans,Vermont,50019,6907,38,6945
7/10/2022,Rutland,Vermont,50021,14645,78,14723
7/10/2022,Unknown,Vermont,,2021,4,2025
7/10/2022,Washington,Vermont,50023,13111,55,13166
7/10/2022,Windham,Vermont,50025,7571,40,7611
7/10/2022,Windsor,Vermont,50027,10300,59,10359
7/10/2022,Accomack,Virginia,51001,7498,108,7606
7/10/2022,Albemarle,Virginia,51003,20826,172,20998
7/10/2022,Alexandria city,Virginia,51510,37453,196,37649
7/10/2022,Alleghany,Virginia,51005,3601,97,3698
7/10/2022,Amelia,Virginia,51007,2864,59,2923
7/10/2022,Amherst,Virginia,51009,7862,91,7953
7/10/2022,Appomattox,Virginia,51011,4121,53,4174
7/10/2022,Arlington,Virginia,51013,54512,325,54837
7/10/2022,Augusta,Virginia,51015,20352,215,20567
7/10/2022,Bath,Virginia,51017,966,20,986
7/10/2022,Bedford,Virginia,51019,18382,247,18629
7/10/2022,Bland,Virginia,51021,1866,24,1890
7/10/2022,Botetourt,Virginia,51023,8059,105,8164
7/10/2022,Bristol city,Virginia,51520,4691,83,4774
7/10/2022,Brunswick,Virginia,51025,3451,47,3498
7/10/2022,Buchanan,Virginia,51027,5067,126,5193
7/10/2022,Buckingham,Virginia,51029,4251,58,4309
7/10/2022,Buena Vista city,Virginia,51530,2141,45,2186
7/10/2022,Campbell,Virginia,51031,14093,220,14313
7/10/2022,Caroline,Virginia,51033,7526,89,7615
7/10/2022,Carroll,Virginia,51035,7201,150,7351
7/10/2022,Charles City,Virginia,51036,1260,29,1289
7/10/2022,Charlotte,Virginia,51037,2720,45,2765
7/10/2022,Charlottesville city,Virginia,51540,10612,78,10690
7/10/2022,Chesapeake city,Virginia,51550,54944,514,55458
7/10/2022,Chesterfield,Virginia,51041,82657,781,83438
7/10/2022,Clarke,Virginia,51043,2926,46,2972
7/10/2022,Colonial Heights city,Virginia,51570,5326,101,5427
7/10/2022,Covington city,Virginia,51580,1493,28,1521
7/10/2022,Craig,Virginia,51045,1171,20,1191
7/10/2022,Culpeper,Virginia,51047,12091,154,12245
7/10/2022,Cumberland,Virginia,51049,1477,27,1504
7/10/2022,Danville city,Virginia,51590,12031,285,12316
7/10/2022,Dickenson,Virginia,51051,3526,50,3576
7/10/2022,Dinwiddie,Virginia,51053,5897,95,5992
7/10/2022,Emporia city,Virginia,51595,1257,55,1312
7/10/2022,Essex,Virginia,51057,2393,35,2428
7/10/2022,Fairfax,Virginia,51059,213680,1483,215163
7/10/2022,Fairfax city,Virginia,51600,2222,44,2266
7/10/2022,Falls Church city,Virginia,51610,2721,17,2738
7/10/2022,Fauquier,Virginia,51061,14101,150,14251
7/10/2022,Floyd,Virginia,51063,2741,49,2790
7/10/2022,Fluvanna,Virginia,51065,5750,47,5797
7/10/2022,Franklin,Virginia,51067,11778,200,11978
7/10/2022,Franklin city,Virginia,51620,2412,52,2464
7/10/2022,Frederick,Virginia,51069,22271,253,22524
7/10/2022,Fredericksburg city,Virginia,51630,5925,41,5966
7/10/2022,Galax city,Virginia,51640,2769,79,2848
7/10/2022,Giles,Virginia,51071,4317,50,4367
7/10/2022,Gloucester,Virginia,51073,7930,106,8036
7/10/2022,Goochland,Virginia,51075,4542,54,4596
7/10/2022,Grayson,Virginia,51077,4275,83,4358
7/10/2022,Greene,Virginia,51079,4362,62,4424
7/10/2022,Greensville,Virginia,51081,3504,41,3545
7/10/2022,Halifax,Virginia,51083,7951,165,8116
7/10/2022,Hampton city,Virginia,51650,31329,336,31665
7/10/2022,Hanover,Virginia,51085,24209,293,24502
7/10/2022,Harrisonburg city,Virginia,51660,14112,165,14277
7/10/2022,Henrico,Virginia,51087,74419,958,75377
7/10/2022,Henry,Virginia,51089,13224,273,13497
7/10/2022,Highland,Virginia,51091,407,7,414
7/10/2022,Hopewell city,Virginia,51670,6524,119,6643
7/10/2022,Isle of Wight,Virginia,51093,7899,119,8018
7/10/2022,James City,Virginia,51095,17309,128,17437
7/10/2022,King and Queen,Virginia,51097,1206,12,1218
7/10/2022,King George,Virginia,51099,5648,44,5692
7/10/2022,King William,Virginia,51101,3981,45,4026
7/10/2022,Lancaster,Virginia,51103,1985,32,2017
7/10/2022,Lee,Virginia,51105,6409,94,6503
7/10/2022,Lexington city,Virginia,51678,2958,40,2998
7/10/2022,Loudoun,Virginia,51107,81147,391,81538
7/10/2022,Louisa,Virginia,51109,7334,85,7419
7/10/2022,Lunenburg,Virginia,51111,2710,39,2749
7/10/2022,Lynchburg city,Virginia,51680,20880,279,21159
7/10/2022,Madison,Virginia,51113,2607,42,2649
7/10/2022,Manassas city,Virginia,51683,9976,72,10048
7/10/2022,Manassas Park city,Virginia,51685,4114,27,4141
7/10/2022,Martinsville city,Virginia,51690,3653,124,3777
7/10/2022,Mathews,Virginia,51115,1630,27,1657
7/10/2022,Mecklenburg,Virginia,51117,6687,126,6813
7/10/2022,Middlesex,Virginia,51119,2018,48,2066
7/10/2022,Montgomery,Virginia,51121,20798,157,20955
7/10/2022,Nelson,Virginia,51125,2782,36,2818
7/10/2022,New Kent,Virginia,51127,5079,34,5113
7/10/2022,Newport News city,Virginia,51700,40646,409,41055
7/10/2022,Norfolk city,Virginia,51710,46392,481,46873
7/10/2022,Northampton,Virginia,51131,2354,66,2420
7/10/2022,Northumberland,Virginia,51133,2330,44,2374
7/10/2022,Norton city,Virginia,51720,1401,22,1423
7/10/2022,Nottoway,Virginia,51135,4579,94,4673
7/10/2022,Orange,Virginia,51137,7437,90,7527
7/10/2022,Page,Virginia,51139,5877,123,6000
7/10/2022,Patrick,Virginia,51141,3922,97,4019
7/10/2022,Petersburg city,Virginia,51730,8712,141,8853
7/10/2022,Pittsylvania,Virginia,51143,15307,209,15516
7/10/2022,Poquoson city,Virginia,51735,2555,30,2585
7/10/2022,Portsmouth city,Virginia,51740,22652,338,22990
7/10/2022,Powhatan,Virginia,51145,5563,62,5625
7/10/2022,Prince Edward,Virginia,51147,5404,77,5481
7/10/2022,Prince George,Virginia,51149,9563,80,9643
7/10/2022,Prince William,Virginia,51153,106823,755,107578
7/10/2022,Pulaski,Virginia,51155,7842,141,7983
7/10/2022,Radford city,Virginia,51750,5337,53,5390
7/10/2022,Rappahannock,Virginia,51157,1110,10,1120
7/10/2022,Richmond,Virginia,51159,2686,25,2711
7/10/2022,Richmond city,Virginia,51760,50808,517,51325
7/10/2022,Roanoke,Virginia,51161,23271,287,23558
7/10/2022,Roanoke city,Virginia,51770,23224,381,23605
7/10/2022,Rockbridge,Virginia,51163,3581,80,3661
7/10/2022,Rockingham,Virginia,51165,15333,236,15569
7/10/2022,Russell,Virginia,51167,7223,116,7339
7/10/2022,Salem city,Virginia,51775,6141,97,6238
7/10/2022,Scott,Virginia,51169,6060,111,6171
7/10/2022,Shenandoah,Virginia,51171,11464,231,11695
7/10/2022,Smyth,Virginia,51173,9372,175,9547
7/10/2022,Southampton,Virginia,51175,3682,96,3778
7/10/2022,Spotsylvania,Virginia,51177,29912,304,30216
7/10/2022,Stafford,Virginia,51179,34447,178,34625
7/10/2022,Staunton city,Virginia,51790,6138,117,6255
7/10/2022,Suffolk city,Virginia,51800,20623,310,20933
7/10/2022,Surry,Virginia,51181,1179,20,1199
7/10/2022,Sussex,Virginia,51183,2564,43,2607
7/10/2022,Tazewell,Virginia,51185,10835,177,11012
7/10/2022,Virginia Beach city,Virginia,51810,99010,849,99859
7/10/2022,Warren,Virginia,51187,9291,159,9450
7/10/2022,Washington,Virginia,51191,14623,217,14840
7/10/2022,Waynesboro city,Virginia,51820,6358,68,6426
7/10/2022,Westmoreland,Virginia,51193,3457,53,3510
7/10/2022,Williamsburg city,Virginia,51830,1940,23,1963
7/10/2022,Winchester city,Virginia,51840,6797,81,6878
7/10/2022,Wise,Virginia,51195,11057,204,11261
7/10/2022,Wythe,Virginia,51197,8000,150,8150
7/10/2022,York,Virginia,51199,11242,112,11354
7/10/2022,St. Croix,Virgin Islands,78010,10636,51,10687
7/10/2022,St. John,Virgin Islands,78020,9479,5,9484
7/10/2022,St. Thomas,Virgin Islands,78030,930,62,992
7/10/2022,Adams,Washington,53001,5120,39,5159
7/10/2022,Asotin,Washington,53003,4795,69,4864
7/10/2022,Benton,Washington,53005,55720,487,56207
7/10/2022,Chelan,Washington,53007,21613,168,21781
7/10/2022,Clallam,Washington,53009,13551,158,13709
7/10/2022,Clark,Washington,53011,99056,855,99911
7/10/2022,Columbia,Washington,53013,651,16,667
7/10/2022,Cowlitz,Washington,53015,24727,358,25085
7/10/2022,Douglas,Washington,53017,11956,73,12029
7/10/2022,Ferry,Washington,53019,1548,29,1577
7/10/2022,Franklin,Washington,53021,33783,216,33999
7/10/2022,Garfield,Washington,53023,423,7,430
7/10/2022,Grant,Washington,53025,28609,260,28869
7/10/2022,Grays Harbor,Washington,53027,18233,207,18440
7/10/2022,Island,Washington,53029,11771,86,11857
7/10/2022,Jefferson,Washington,53031,3783,30,3813
7/10/2022,King,Washington,53033,473731,2930,476661
7/10/2022,Kitsap,Washington,53035,45452,366,45818
7/10/2022,Kittitas,Washington,53037,9338,72,9410
7/10/2022,Klickitat,Washington,53039,3854,51,3905
7/10/2022,Lewis,Washington,53041,18923,265,19188
7/10/2022,Lincoln,Washington,53043,2374,29,2403
7/10/2022,Mason,Washington,53045,13601,145,13746
7/10/2022,Okanogan,Washington,53047,9162,127,9289
7/10/2022,Pacific,Washington,53049,4186,62,4248
7/10/2022,Pend Oreille,Washington,53051,2615,37,2652
7/10/2022,Pierce,Washington,53053,215783,1440,217223
7/10/2022,San Juan,Washington,53055,1684,2,1686
7/10/2022,Skagit,Washington,53057,24685,216,24901
7/10/2022,Skamania,Washington,53059,1641,12,1653
7/10/2022,Snohomish,Washington,53061,177144,1199,178343
7/10/2022,Spokane,Washington,53063,135163,1437,136600
7/10/2022,Stevens,Washington,53065,8738,151,8889
7/10/2022,Thurston,Washington,53067,54719,431,55150
7/10/2022,Wahkiakum,Washington,53069,564,7,571
7/10/2022,Walla Walla,Washington,53071,17463,149,17612
7/10/2022,Whatcom,Washington,53073,43552,309,43861
7/10/2022,Whitman,Washington,53075,9058,90,9148
7/10/2022,Yakima,Washington,53077,76837,799,77636
7/10/2022,Barbour,West Virginia,54001,5152,74,5226
7/10/2022,Berkeley,West Virginia,54003,38283,310,38593
7/10/2022,Boone,West Virginia,54005,7093,78,7171
7/10/2022,Braxton,West Virginia,54007,4260,45,4305
7/10/2022,Brooke,West Virginia,54009,5396,104,5500
7/10/2022,Cabell,West Virginia,54011,29473,386,29859
7/10/2022,Calhoun,West Virginia,54013,1988,15,2003
7/10/2022,Clay,West Virginia,54015,2439,46,2485
7/10/2022,Doddridge,West Virginia,54017,2233,18,2251
7/10/2022,Fayette,West Virginia,54019,14014,210,14224
7/10/2022,Gilmer,West Virginia,54021,2220,19,2239
7/10/2022,Grant,West Virginia,54023,3953,56,4009
7/10/2022,Greenbrier,West Virginia,54025,10490,163,10653
7/10/2022,Hampshire,West Virginia,54027,6217,74,6291
7/10/2022,Hancock,West Virginia,54029,7217,142,7359
7/10/2022,Hardy,West Virginia,54031,4424,49,4473
7/10/2022,Harrison,West Virginia,54033,21702,258,21960
7/10/2022,Jackson,West Virginia,54035,7311,136,7447
7/10/2022,Jefferson,West Virginia,54037,15535,135,15670
7/10/2022,Kanawha,West Virginia,54039,50813,746,51559
7/10/2022,Lewis,West Virginia,54041,5855,88,5943
7/10/2022,Lincoln,West Virginia,54043,5899,84,5983
7/10/2022,Logan,West Virginia,54045,10413,190,10603
7/10/2022,Marion,West Virginia,54049,16529,181,16710
7/10/2022,Marshall,West Virginia,54051,9598,156,9754
7/10/2022,Mason,West Virginia,54053,7262,96,7358
7/10/2022,McDowell,West Virginia,54047,6019,77,6096
7/10/2022,Mercer,West Virginia,54055,18411,269,18680
7/10/2022,Mineral,West Virginia,54057,8523,160,8683
7/10/2022,Mingo,West Virginia,54059,8294,124,8418
7/10/2022,Monongalia,West Virginia,54061,26899,198,27097
7/10/2022,Monroe,West Virginia,54063,4577,46,4623
7/10/2022,Morgan,West Virginia,54065,4464,70,4534
7/10/2022,Nicholas,West Virginia,54067,7892,99,7991
7/10/2022,Ohio,West Virginia,54069,12052,178,12230
7/10/2022,Pendleton,West Virginia,54071,2053,22,2075
7/10/2022,Pleasants,West Virginia,54073,2158,38,2196
7/10/2022,Pocahontas,West Virginia,54075,2128,32,2160
7/10/2022,Preston,West Virginia,54077,9734,140,9874
7/10/2022,Putnam,West Virginia,54079,17873,187,18060
7/10/2022,Raleigh,West Virginia,54081,24780,368,25148
7/10/2022,Randolph,West Virginia,54083,10111,91,10202
7/10/2022,Ritchie,West Virginia,54085,2576,31,2607
7/10/2022,Roane,West Virginia,54087,3503,37,3540
7/10/2022,Summers,West Virginia,54089,3016,55,3071
7/10/2022,Taylor,West Virginia,54091,4922,73,4995
7/10/2022,Tucker,West Virginia,54093,2094,38,2132
7/10/2022,Tyler,West Virginia,54095,2314,32,2346
7/10/2022,Upshur,West Virginia,54097,7433,96,7529
7/10/2022,Wayne,West Virginia,54099,10374,128,10502
7/10/2022,Webster,West Virginia,54101,2396,34,2430
7/10/2022,Wetzel,West Virginia,54103,4665,87,4752
7/10/2022,Wirt,West Virginia,54105,1516,25,1541
7/10/2022,Wood,West Virginia,54107,23399,353,23752
7/10/2022,Wyoming,West Virginia,54109,7498,122,7620
7/10/2022,Adams,Wisconsin,55001,5024,63,5087
7/10/2022,Ashland,Wisconsin,55003,3654,39,3693
7/10/2022,Barron,Wisconsin,55005,14244,147,14391
7/10/2022,Bayfield,Wisconsin,55007,3795,42,3837
7/10/2022,Brown,Wisconsin,55009,89952,569,90521
7/10/2022,Buffalo,Wisconsin,55011,3747,12,3759
7/10/2022,Burnett,Wisconsin,55013,4341,45,4386
7/10/2022,Calumet,Wisconsin,55015,15280,125,15405
7/10/2022,Chippewa,Wisconsin,55017,19778,192,19970
7/10/2022,Clark,Wisconsin,55019,7983,122,8105
7/10/2022,Columbia,Wisconsin,55021,16895,133,17028
7/10/2022,Crawford,Wisconsin,55023,4493,28,4521
7/10/2022,Dane,Wisconsin,55025,150785,534,151319
7/10/2022,Dodge,Wisconsin,55027,28524,342,28866
7/10/2022,Door,Wisconsin,55029,7539,73,7612
7/10/2022,Douglas,Wisconsin,55031,12767,80,12847
7/10/2022,Dunn,Wisconsin,55033,14093,76,14169
7/10/2022,Eau Claire,Wisconsin,55035,32582,194,32776
7/10/2022,Florence,Wisconsin,55037,1143,17,1160
7/10/2022,Fond du Lac,Wisconsin,55039,33945,285,34230
7/10/2022,Forest,Wisconsin,55041,2871,52,2923
7/10/2022,Grant,Wisconsin,55043,13582,149,13731
7/10/2022,Green,Wisconsin,55045,10007,55,10062
7/10/2022,Green Lake,Wisconsin,55047,5511,65,5576
7/10/2022,Iowa,Wisconsin,55049,5861,30,5891
7/10/2022,Iron,Wisconsin,55051,1556,48,1604
7/10/2022,Jackson,Wisconsin,55053,5969,43,6012
7/10/2022,Jefferson,Wisconsin,55055,23164,246,23410
7/10/2022,Juneau,Wisconsin,55057,8238,70,8308
7/10/2022,Kenosha,Wisconsin,55059,48117,647,48764
7/10/2022,Kewaunee,Wisconsin,55061,6127,60,6187
7/10/2022,La Crosse,Wisconsin,55063,38069,189,38258
7/10/2022,Lafayette,Wisconsin,55065,3922,29,3951
7/10/2022,Langlade,Wisconsin,55067,5652,92,5744
7/10/2022,Lincoln,Wisconsin,55069,7695,152,7847
7/10/2022,Manitowoc,Wisconsin,55071,21813,191,22004
7/10/2022,Marathon,Wisconsin,55073,42789,507,43296
7/10/2022,Marinette,Wisconsin,55075,12290,132,12422
7/10/2022,Marquette,Wisconsin,55077,4101,63,4164
7/10/2022,Menominee,Wisconsin,55078,2034,15,2049
7/10/2022,Milwaukee,Wisconsin,55079,295039,2328,297367
7/10/2022,Monroe,Wisconsin,55081,12867,99,12966
7/10/2022,Oconto,Wisconsin,55083,11884,124,12008
7/10/2022,Oneida,Wisconsin,55085,9265,139,9404
7/10/2022,Outagamie,Wisconsin,55087,57668,419,58087
7/10/2022,Ozaukee,Wisconsin,55089,24683,192,24875
7/10/2022,Pepin,Wisconsin,55091,2069,18,2087
7/10/2022,Pierce,Wisconsin,55093,12294,73,12367
7/10/2022,Polk,Wisconsin,55095,13172,121,13293
7/10/2022,Portage,Wisconsin,55097,19581,161,19742
7/10/2022,Price,Wisconsin,55099,3473,34,3507
7/10/2022,Racine,Wisconsin,55101,61316,704,62020
7/10/2022,Richland,Wisconsin,55103,4227,51,4278
7/10/2022,Rock,Wisconsin,55105,46878,403,47281
7/10/2022,Rusk,Wisconsin,55107,3615,58,3673
7/10/2022,Sauk,Wisconsin,55111,17707,138,17845
7/10/2022,Sawyer,Wisconsin,55113,4966,63,5029
7/10/2022,Shawano,Wisconsin,55115,12379,155,12534
7/10/2022,Sheboygan,Wisconsin,55117,34894,332,35226
7/10/2022,St. Croix,Wisconsin,55109,26968,155,27123
7/10/2022,Taylor,Wisconsin,55119,5045,73,5118
7/10/2022,Trempealeau,Wisconsin,55121,8819,66,8885
7/10/2022,Vernon,Wisconsin,55123,6633,103,6736
7/10/2022,Vilas,Wisconsin,55125,5632,91,5723
7/10/2022,Walworth,Wisconsin,55127,28620,287,28907
7/10/2022,Washburn,Wisconsin,55129,4300,46,4346
7/10/2022,Washington,Wisconsin,55131,41176,348,41524
7/10/2022,Waukesha,Wisconsin,55133,123297,1127,124424
7/10/2022,Waupaca,Wisconsin,55135,14389,256,14645
7/10/2022,Waushara,Wisconsin,55137,6754,87,6841
7/10/2022,Winnebago,Wisconsin,55139,55677,394,56071
7/10/2022,Wood,Wisconsin,55141,23006,238,23244
7/10/2022,Albany,Wyoming,56001,10548,51,10599
7/10/2022,Big Horn,Wyoming,56003,2714,63,2777
7/10/2022,Campbell,Wyoming,56005,12520,149,12669
7/10/2022,Carbon,Wyoming,56007,4806,52,4858
7/10/2022,Converse,Wyoming,56009,3257,55,3312
7/10/2022,Crook,Wyoming,56011,1398,29,1427
7/10/2022,Fremont,Wyoming,56013,14635,194,14829
7/10/2022,Goshen,Wyoming,56015,3848,57,3905
7/10/2022,Hot Springs,Wyoming,56017,1247,17,1264
7/10/2022,Johnson,Wyoming,56019,1986,20,2006
7/10/2022,Laramie,Wyoming,56021,27980,293,28273
7/10/2022,Lincoln,Wyoming,56023,4363,32,4395
7/10/2022,Natrona,Wyoming,56025,23197,275,23472
7/10/2022,Niobrara,Wyoming,56027,722,10,732
7/10/2022,Park,Wyoming,56029,7113,144,7257
7/10/2022,Platte,Wyoming,56031,2018,41,2059
7/10/2022,Sheridan,Wyoming,56033,8685,81,8766
7/10/2022,Sublette,Wyoming,56035,2017,27,2044
7/10/2022,Sweetwater,Wyoming,56037,11634,126,11760
7/10/2022,Teton,Wyoming,56039,10911,16,10927
7/10/2022,Uinta,Wyoming,56041,5856,39,5895
7/10/2022,Washakie,Wyoming,56043,2497,44,2541
7/10/2022,Weston,Wyoming,56045,1667,19,1686
7/24/2022,Autauga,Alabama,1001,17268,220,17488
7/24/2022,Baldwin,Alabama,1003,61268,686,61954
7/24/2022,Barbour,Alabama,1005,6205,100,6305
7/24/2022,Bibb,Alabama,1007,6882,105,6987
7/24/2022,Blount,Alabama,1009,15846,247,16093
7/24/2022,Bullock,Alabama,1011,2592,54,2646
7/24/2022,Butler,Alabama,1013,5480,129,5609
7/24/2022,Calhoun,Alabama,1015,34233,638,34871
7/24/2022,Chambers,Alabama,1017,9233,165,9398
7/24/2022,Cherokee,Alabama,1019,5468,87,5555
7/24/2022,Chilton,Alabama,1021,11657,212,11869
7/24/2022,Choctaw,Alabama,1023,2134,37,2171
7/24/2022,Clarke,Alabama,1025,7589,101,7690
7/24/2022,Clay,Alabama,1027,4375,83,4458
7/24/2022,Cleburne,Alabama,1029,3689,69,3758
7/24/2022,Coffee,Alabama,1031,14716,236,14952
7/24/2022,Colbert,Alabama,1033,17728,264,17992
7/24/2022,Conecuh,Alabama,1035,3119,70,3189
7/24/2022,Coosa,Alabama,1037,3200,59,3259
7/24/2022,Covington,Alabama,1039,10097,236,10333
7/24/2022,Crenshaw,Alabama,1041,4085,102,4187
7/24/2022,Cullman,Alabama,1043,26525,371,26896
7/24/2022,Dale,Alabama,1045,14101,234,14335
7/24/2022,Dallas,Alabama,1047,9331,247,9578
7/24/2022,DeKalb,Alabama,1049,19672,333,20005
7/24/2022,Elmore,Alabama,1051,25591,352,25943
7/24/2022,Escambia,Alabama,1053,10856,174,11030
7/24/2022,Etowah,Alabama,1055,30047,655,30702
7/24/2022,Fayette,Alabama,1057,5175,97,5272
7/24/2022,Franklin,Alabama,1059,10269,140,10409
7/24/2022,Geneva,Alabama,1061,6921,165,7086
7/24/2022,Greene,Alabama,1063,2032,51,2083
7/24/2022,Hale,Alabama,1065,5135,108,5243
7/24/2022,Henry,Alabama,1067,5001,78,5079
7/24/2022,Houston,Alabama,1069,27965,511,28476
7/24/2022,Jackson,Alabama,1071,15813,244,16057
7/24/2022,Jefferson,Alabama,1073,203119,2396,205515
7/24/2022,Lamar,Alabama,1075,4000,65,4065
7/24/2022,Lauderdale,Alabama,1077,25845,402,26247
7/24/2022,Crittenden,Arkansas,5035,15209,228,15437
7/24/2022,Cross,Arkansas,5037,5155,87,5242
7/24/2022,Dallas,Arkansas,5039,1869,32,1901
7/24/2022,Desha,Arkansas,5041,3271,41,3312
7/24/2022,Drew,Arkansas,5043,4901,71,4972
7/24/2022,Faulkner,Arkansas,5045,37920,321,38241
7/24/2022,Franklin,Arkansas,5047,4039,73,4112
7/24/2022,Fulton,Arkansas,5049,2823,94,2917
7/24/2022,Garland,Arkansas,5051,24565,518,25083
7/24/2022,Grant,Arkansas,5053,4705,62,4767
7/24/2022,Greene,Arkansas,5055,17034,182,17216
7/24/2022,Hempstead,Arkansas,5057,5004,70,5074
7/24/2022,Hot Spring,Arkansas,5059,11760,141,11901
7/24/2022,Howard,Arkansas,5061,4063,52,4115
7/24/2022,Independence,Arkansas,5063,11270,215,11485
7/24/2022,Izard,Arkansas,5065,4164,72,4236
7/24/2022,Jackson,Arkansas,5067,6448,64,6512
7/24/2022,Jefferson,Arkansas,5069,20007,280,20287
7/24/2022,Johnson,Arkansas,5071,7262,88,7350
7/24/2022,Lafayette,Arkansas,5073,1355,30,1385
7/24/2022,Lawrence,Arkansas,5075,5688,82,5770
7/24/2022,Lee,Arkansas,5077,3041,62,3103
7/24/2022,Lincoln,Arkansas,5079,5066,69,5135
7/24/2022,Little River,Arkansas,5081,3441,106,3547
7/24/2022,Logan,Arkansas,5083,5370,79,5449
7/24/2022,Lonoke,Arkansas,5085,21410,249,21659
7/24/2022,Madison,Arkansas,5087,4250,65,4315
7/24/2022,Marion,Arkansas,5089,3626,89,3715
7/24/2022,Miller,Arkansas,5091,10227,182,10409
7/24/2022,Mississippi,Arkansas,5093,14354,214,14568
7/24/2022,Monroe,Arkansas,5095,2072,36,2108
7/24/2022,Montgomery,Arkansas,5097,1641,56,1697
7/24/2022,Nevada,Arkansas,5099,2376,45,2421
7/24/2022,Newton,Arkansas,5101,1811,49,1860
7/24/2022,Ouachita,Arkansas,5103,5975,109,6084
7/24/2022,Perry,Arkansas,5105,2677,38,2715
7/24/2022,Phillips,Arkansas,5107,5142,100,5242
7/24/2022,Pike,Arkansas,5109,2707,44,2751
7/24/2022,Poinsett,Arkansas,5111,8596,130,8726
7/24/2022,Polk,Arkansas,5113,4297,151,4448
7/24/2022,Pope,Arkansas,5115,19290,213,19503
7/24/2022,Prairie,Arkansas,5117,2069,43,2112
7/24/2022,Pulaski,Arkansas,5119,113703,1197,114900
7/24/2022,Randolph,Arkansas,5121,5550,93,5643
7/24/2022,Saline,Arkansas,5125,33123,348,33471
7/24/2022,Scott,Arkansas,5127,2537,44,2581
7/24/2022,Searcy,Arkansas,5129,2260,49,2309
7/24/2022,Sebastian,Arkansas,5131,35262,535,35797
7/24/2022,Sevier,Arkansas,5133,6298,76,6374
7/24/2022,Sharp,Arkansas,5135,5052,110,5162
7/24/2022,St. Francis,Arkansas,5123,7686,97,7783
7/24/2022,Stone,Arkansas,5137,3191,68,3259
7/24/2022,Union,Arkansas,5139,9951,182,10133
7/24/2022,Unknown,Arkansas,,28992,0,28992
7/24/2022,Van Buren,Arkansas,5141,3747,62,3809
7/24/2022,Washington,Arkansas,5143,72864,643,73507
7/24/2022,White,Arkansas,5145,23732,305,24037
7/24/2022,Woodruff,Arkansas,5147,1870,31,1901
7/24/2022,Yell,Arkansas,5149,7054,108,7162
7/24/2022,Alameda,California,6001,341980,1962,343942
7/24/2022,Alpine,California,6003,131,0,131
7/24/2022,Amador,California,6005,10357,87,10444
7/24/2022,Butte,California,6007,45069,440,45509
7/24/2022,Calaveras,California,6009,8524,128,8652
7/24/2022,Colusa,California,6011,4855,22,4877
7/24/2022,Contra Costa,California,6013,250139,1363,251502
7/24/2022,Del Norte,California,6015,7545,54,7599
7/24/2022,El Dorado,California,6017,34690,222,34912
7/24/2022,Fresno,California,6019,285274,2792,288066
7/24/2022,Glenn,California,6021,7087,48,7135
7/24/2022,Humboldt,California,6023,24732,151,24883
7/24/2022,Imperial,California,6025,75287,948,76235
7/24/2022,Inyo,California,6027,5146,57,5203
7/24/2022,Kern,California,6029,267582,2484,270066
7/24/2022,Kings,California,6031,60050,451,60501
7/24/2022,Lake,California,6033,13022,142,13164
7/24/2022,Lassen,California,6035,11244,68,11312
7/24/2022,Los Angeles,California,6037,3254027,32604,3286631
7/24/2022,Madera,California,6039,48378,372,48750
7/24/2022,Marin,California,6041,47262,300,47562
7/24/2022,Mariposa,California,6043,3865,36,3901
7/24/2022,Mendocino,California,6045,18997,131,19128
7/24/2022,Merced,California,6047,78450,837,79287
7/24/2022,Modoc,California,6049,1122,10,1132
7/24/2022,Mono,California,6051,3358,7,3365
7/24/2022,Monterey,California,6053,107773,764,108537
7/24/2022,Napa,California,6055,31839,148,31987
7/24/2022,Nevada,California,6057,19674,131,19805
7/24/2022,Orange,California,6059,682670,7189,689859
7/24/2022,Placer,California,6061,80602,644,81246
7/24/2022,Plumas,California,6063,3888,13,3901
7/24/2022,Riverside,California,6065,688438,6584,695022
7/24/2022,Sacramento,California,6067,358705,3309,362014
7/24/2022,San Benito,California,6069,15864,100,15964
7/24/2022,San Bernardino,California,6071,654512,7933,662445
7/24/2022,San Diego,California,6073,935658,5380,941038
7/24/2022,San Francisco,California,6075,178632,931,179563
7/24/2022,San Joaquin,California,6077,199118,2267,201385
7/24/2022,San Luis Obispo,California,6079,66294,500,66794
7/24/2022,San Mateo,California,6081,167314,787,168101
7/24/2022,Santa Barbara,California,6083,104796,706,105502
7/24/2022,Santa Clara,California,6085,419103,2381,421484
7/24/2022,Santa Cruz,California,6087,61463,268,61731
7/24/2022,Shasta,California,6089,40090,664,40754
7/24/2022,Sierra,California,6091,352,4,356
7/24/2022,Siskiyou,California,6093,8080,107,8187
7/24/2022,Solano,California,6095,105254,457,105711
7/24/2022,Sonoma,California,6097,105441,500,105941
7/24/2022,Stanislaus,California,6099,149680,1695,151375
7/24/2022,Sutter,California,6101,25103,235,25338
7/24/2022,Tehama,California,6103,15880,207,16087
7/24/2022,Trinity,California,6105,1673,20,1693
7/24/2022,Tulare,California,6107,148874,1513,150387
7/24/2022,Tuolumne,California,6109,15709,196,15905
7/24/2022,Ventura,California,6111,209493,1525,211018
7/24/2022,Yolo,California,6113,49279,327,49606
7/24/2022,Yuba,California,6115,19346,124,19470
7/24/2022,Adams,Colorado,8001,154323,1425,155748
7/24/2022,Alamosa,Colorado,8003,5142,62,5204
7/24/2022,Arapahoe,Colorado,8005,181443,1336,182779
7/24/2022,Archuleta,Colorado,8007,3141,16,3157
7/24/2022,Baca,Colorado,8009,903,14,917
7/24/2022,Bent,Colorado,8011,2681,47,2728
7/24/2022,Boulder,Colorado,8013,80568,384,80952
7/24/2022,Broomfield,Colorado,8014,16309,121,16430
7/24/2022,Chaffee,Colorado,8015,5210,50,5260
7/24/2022,Cheyenne,Colorado,8017,334,9,343
7/24/2022,Clear Creek,Colorado,8019,1789,12,1801
7/24/2022,Conejos,Colorado,8021,2038,57,2095
7/24/2022,Costilla,Colorado,8023,824,18,842
7/24/2022,Crowley,Colorado,8025,3418,31,3449
7/24/2022,Custer,Colorado,8027,754,22,776
7/24/2022,Delta,Colorado,8029,6634,142,6776
7/24/2022,Denver,Colorado,8031,202938,1407,204345
7/24/2022,Dolores,Colorado,8033,381,8,389
7/24/2022,Douglas,Colorado,8035,93159,486,93645
7/24/2022,Eagle,Colorado,8037,17610,36,17646
7/24/2022,Elbert,Colorado,8039,5357,42,5399
7/24/2022,El Paso,Colorado,8041,212328,1760,214088
7/24/2022,Fremont,Colorado,8043,16723,192,16915
7/24/2022,Garfield,Colorado,8045,16566,95,16661
7/24/2022,Gilpin,Colorado,8047,1086,5,1091
7/24/2022,Grand,Colorado,8049,3803,28,3831
7/24/2022,Gunnison,Colorado,8051,3682,14,3696
7/24/2022,Hinsdale,Colorado,8053,145,0,145
7/24/2022,Huerfano,Colorado,8055,1609,38,1647
7/24/2022,Jackson,Colorado,8057,186,0,186
7/24/2022,Jefferson,Colorado,8059,145593,1408,147001
7/24/2022,Kiowa,Colorado,8061,350,6,356
7/24/2022,Kit Carson,Colorado,8063,1699,33,1732
7/24/2022,Lake,Colorado,8065,2041,2,2043
7/24/2022,La Plata,Colorado,8067,14259,89,14348
7/24/2022,Larimer,Colorado,8069,94835,530,95365
7/24/2022,Las Animas,Colorado,8071,3866,45,3911
7/24/2022,Lincoln,Colorado,8073,2300,10,2310
7/24/2022,Logan,Colorado,8075,7894,112,8006
7/24/2022,Mesa,Colorado,8077,46419,592,47011
7/24/2022,Mineral,Colorado,8079,275,2,277
7/24/2022,Moffat,Colorado,8081,3299,53,3352
7/24/2022,Montezuma,Colorado,8083,6655,83,6738
7/24/2022,Montrose,Colorado,8085,10186,170,10356
7/24/2022,Morgan,Colorado,8087,6158,138,6296
7/24/2022,Otero,Colorado,8089,4701,132,4833
7/24/2022,Ouray,Colorado,8091,1013,6,1019
7/24/2022,Park,Colorado,8093,3211,22,3233
7/24/2022,Phillips,Colorado,8095,943,19,962
7/24/2022,Pitkin,Colorado,8097,7533,8,7541
7/24/2022,Prowers,Colorado,8099,2782,51,2833
7/24/2022,Pueblo,Colorado,8101,53563,819,54382
7/24/2022,Rio Blanco,Colorado,8103,1905,13,1918
7/24/2022,Rio Grande,Colorado,8105,3193,46,3239
7/24/2022,Routt,Colorado,8107,7244,25,7269
7/24/2022,Saguache,Colorado,8109,1341,12,1353
7/24/2022,San Juan,Colorado,8111,286,0,286
7/24/2022,San Miguel,Colorado,8113,2543,8,2551
7/24/2022,Sedgwick,Colorado,8115,506,10,516
7/24/2022,Summit,Colorado,8117,11247,14,11261
7/24/2022,Teller,Colorado,8119,5437,58,5495
7/24/2022,Washington,Colorado,8121,1104,29,1133
7/24/2022,Weld,Colorado,8123,95745,717,96462
7/24/2022,Yuma,Colorado,8125,2081,25,2106
7/24/2022,Fairfield,Connecticut,9001,232138,2759,234897
7/24/2022,Hartford,Connecticut,9003,204429,3206,207635
7/24/2022,Litchfield,Connecticut,9005,36077,469,36546
7/24/2022,Middlesex,Connecticut,9007,33581,489,34070
7/24/2022,New Haven,Connecticut,9009,222468,2886,225354
7/24/2022,New London,Connecticut,9011,63466,686,64152
7/24/2022,Tolland,Connecticut,9013,24134,287,24421
7/24/2022,Unknown,Connecticut,,2696,1,2697
7/24/2022,Windham,Connecticut,9015,28266,310,28576
7/24/2022,Kent,Delaware,10001,56511,666,57177
7/24/2022,New Castle,Delaware,10003,165999,1470,167469
7/24/2022,Sussex,Delaware,10005,68104,885,68989
7/24/2022,Unknown,Delaware,,1005,0,1005
7/24/2022,District of Columbia,District of Columbia,11001,161169,1363,162532
7/24/2022,Alachua,Florida,12001,77352,696,78048
7/24/2022,Baker,Florida,12003,9139,143,9282
7/24/2022,Bay,Florida,12005,49375,837,50212
7/24/2022,Bradford,Florida,12007,8042,154,8196
7/24/2022,Brevard,Florida,12009,153217,2204,155421
7/24/2022,Broward,Florida,12011,689030,6067,695097
7/24/2022,Calhoun,Florida,12013,4309,99,4408
7/24/2022,Charlotte,Florida,12015,41069,843,41912
7/24/2022,Citrus,Florida,12017,33456,1006,34462
7/24/2022,Clay,Florida,12019,58887,881,59768
7/24/2022,Collier,Florida,12021,92548,1035,93583
7/24/2022,Columbia,Florida,12023,22534,416,22950
7/24/2022,DeSoto,Florida,12027,10147,154,10301
7/24/2022,Dixie,Florida,12029,4359,74,4433
7/24/2022,Duval,Florida,12031,279854,3488,283342
7/24/2022,Escambia,Florida,12033,84363,1347,85710
7/24/2022,Flagler,Florida,12035,25263,379,25642
7/24/2022,Franklin,Florida,12037,3243,53,3296
7/24/2022,Gadsden,Florida,12039,14964,212,15176
7/24/2022,Gilchrist,Florida,12041,4942,101,5043
7/24/2022,Glades,Florida,12043,2110,36,2146
7/24/2022,Gulf,Florida,12045,4580,80,4660
7/24/2022,Hamilton,Florida,12047,4022,56,4078
7/24/2022,Hardee,Florida,12049,9216,125,9341
7/24/2022,Hendry,Florida,12051,12507,162,12669
7/24/2022,Hernando,Florida,12053,47099,1134,48233
7/24/2022,Highlands,Florida,12055,26547,703,27250
7/24/2022,Hillsborough,Florida,12057,422941,3936,426877
7/24/2022,Holmes,Florida,12059,5746,93,5839
7/24/2022,Indian River,Florida,12061,37227,684,37911
7/24/2022,Jackson,Florida,12063,15853,285,16138
7/24/2022,Jefferson,Florida,12065,4350,61,4411
7/24/2022,Lafayette,Florida,12067,2908,61,2969
7/24/2022,Lake,Florida,12069,95543,1569,97112
7/24/2022,Lee,Florida,12071,211155,2226,213381
7/24/2022,Leon,Florida,12073,96702,687,97389
7/24/2022,Levy,Florida,12075,11092,169,11261
7/24/2022,Liberty,Florida,12077,2637,30,2667
7/24/2022,Madison,Florida,12079,6299,98,6397
7/24/2022,Manatee,Florida,12081,107819,1509,109328
7/24/2022,Marion,Florida,12083,91631,2172,93803
7/24/2022,Martin,Florida,12085,34499,644,35143
7/24/2022,Miami-Dade,Florida,12086,1366912,11271,1378183
7/24/2022,Monroe,Florida,12087,20321,124,20445
7/24/2022,Nassau,Florida,12089,24222,306,24528
7/24/2022,Okaloosa,Florida,12091,55605,705,56310
7/24/2022,Okeechobee,Florida,12093,11270,186,11456
7/24/2022,Orange,Florida,12095,426024,2931,428955
7/24/2022,Osceola,Florida,12097,127841,1171,129012
7/24/2022,Palm Beach,Florida,12099,419962,5275,425237
7/24/2022,Pasco,Florida,12101,138819,1986,140805
7/24/2022,Pinellas,Florida,12103,240405,3503,243908
7/24/2022,Polk,Florida,12105,225936,3074,229010
7/24/2022,Putnam,Florida,12107,18954,431,19385
7/24/2022,Santa Rosa,Florida,12113,52637,635,53272
7/24/2022,Sarasota,Florida,12115,104198,1713,105911
7/24/2022,Seminole,Florida,12117,117296,1128,118424
7/24/2022,St. Johns,Florida,12109,69528,589,70117
7/24/2022,St. Lucie,Florida,12111,83423,1263,84686
7/24/2022,Sumter,Florida,12119,25219,602,25821
7/24/2022,Suwannee,Florida,12121,13687,321,14008
7/24/2022,Taylor,Florida,12123,7382,102,7484
7/24/2022,Union,Florida,12125,4552,119,4671
7/24/2022,Unknown,Florida,,76071,436,76507
7/24/2022,Volusia,Florida,12127,131891,2057,133948
7/24/2022,Wakulla,Florida,12129,10688,131,10819
7/24/2022,Walton,Florida,12131,17691,217,17908
7/24/2022,Washington,Florida,12133,7002,113,7115
7/24/2022,Appling,Georgia,13001,4923,132,5055
7/24/2022,Atkinson,Georgia,13003,2266,52,2318
7/24/2022,Bacon,Georgia,13005,3859,78,3937
7/24/2022,Baker,Georgia,13007,577,15,592
7/24/2022,Baldwin,Georgia,13009,10069,245,10314
7/24/2022,Banks,Georgia,13011,4166,98,4264
7/24/2022,Barrow,Georgia,13013,23183,261,23444
7/24/2022,Bartow,Georgia,13015,31096,454,31550
7/24/2022,Ben Hill,Georgia,13017,4508,123,4631
7/24/2022,Berrien,Georgia,13019,5170,85,5255
7/24/2022,Bibb,Georgia,13021,40589,801,41390
7/24/2022,Bleckley,Georgia,13023,3513,101,3614
7/24/2022,Brantley,Georgia,13025,4321,111,4432
7/24/2022,Brooks,Georgia,13027,3612,87,3699
7/24/2022,Bryan,Georgia,13029,9861,94,9955
7/24/2022,Bulloch,Georgia,13031,16233,267,16500
7/24/2022,Burke,Georgia,13033,5590,113,5703
7/24/2022,Butts,Georgia,13035,6909,164,7073
7/24/2022,Calhoun,Georgia,13037,1427,24,1451
7/24/2022,Camden,Georgia,13039,12350,127,12477
7/24/2022,Candler,Georgia,13043,2324,101,2425
7/24/2022,Carroll,Georgia,13045,25235,468,25703
7/24/2022,Catoosa,Georgia,13047,15556,181,15737
7/24/2022,Charlton,Georgia,13049,3189,63,3252
7/24/2022,Chatham,Georgia,13051,70131,913,71044
7/24/2022,Chattahoochee,Georgia,13053,7572,22,7594
7/24/2022,Chattooga,Georgia,13055,6993,136,7129
7/24/2022,Cherokee,Georgia,13057,68188,648,68836
7/24/2022,Clarke,Georgia,13059,31741,240,31981
7/24/2022,Clay,Georgia,13061,549,6,555
7/24/2022,Clayton,Georgia,13063,69474,1007,70481
7/24/2022,Clinch,Georgia,13065,2215,42,2257
7/24/2022,Cobb,Georgia,13067,193221,1890,195111
7/24/2022,Coffee,Georgia,13069,11008,282,11290
7/24/2022,Colquitt,Georgia,13071,12380,250,12630
7/24/2022,Columbia,Georgia,13073,38540,395,38935
7/24/2022,Cook,Georgia,13075,5171,75,5246
7/24/2022,Coweta,Georgia,13077,36104,500,36604
7/24/2022,Crawford,Georgia,13079,1898,55,1953
7/24/2022,Crisp,Georgia,13081,4993,137,5130
7/24/2022,Dade,Georgia,13083,3606,33,3639
7/24/2022,Dawson,Georgia,13085,7465,101,7566
7/24/2022,Decatur,Georgia,13087,7743,133,7876
7/24/2022,DeKalb,Georgia,13089,169948,1791,171739
7/24/2022,Dodge,Georgia,13091,5448,156,5604
7/24/2022,Dooly,Georgia,13093,2515,69,2584
7/24/2022,Dougherty,Georgia,13095,21524,511,22035
7/24/2022,Douglas,Georgia,13097,38078,414,38492
7/24/2022,Early,Georgia,13099,2937,65,3002
7/24/2022,Echols,Georgia,13101,974,12,986
7/24/2022,Effingham,Georgia,13103,14352,200,14552
7/24/2022,Elbert,Georgia,13105,4699,112,4811
7/24/2022,Emanuel,Georgia,13107,6178,162,6340
7/24/2022,Evans,Georgia,13109,2533,64,2597
7/24/2022,Fannin,Georgia,13111,5374,165,5539
7/24/2022,Fayette,Georgia,13113,25479,334,25813
7/24/2022,Floyd,Georgia,13115,28825,528,29353
7/24/2022,Forsyth,Georgia,13117,60759,413,61172
7/24/2022,Franklin,Georgia,13119,5599,104,5703
7/24/2022,Fulton,Georgia,13121,245276,2415,247691
7/24/2022,Gilmer,Georgia,13123,7348,182,7530
7/24/2022,Glascock,Georgia,13125,637,25,662
7/24/2022,Glynn,Georgia,13127,24835,412,25247
7/24/2022,Gordon,Georgia,13129,17747,274,18021
7/24/2022,Grady,Georgia,13131,6207,113,6320
7/24/2022,Greene,Georgia,13133,4224,85,4309
7/24/2022,Gwinnett,Georgia,13135,227541,1926,229467
7/24/2022,Habersham,Georgia,13137,10598,267,10865
7/24/2022,Hall,Georgia,13139,57621,858,58479
7/24/2022,Hancock,Georgia,13141,1690,90,1780
7/24/2022,Haralson,Georgia,13143,5721,178,5899
7/24/2022,Harris,Georgia,13145,6437,118,6555
7/24/2022,Hart,Georgia,13147,5071,104,5175
7/24/2022,Heard,Georgia,13149,2284,56,2340
7/24/2022,Henry,Georgia,13151,63178,699,63877
7/24/2022,Houston,Georgia,13153,43281,506,43787
7/24/2022,Irwin,Georgia,13155,2010,51,2061
7/24/2022,Jackson,Georgia,13157,22227,294,22521
7/24/2022,Jasper,Georgia,13159,3337,73,3410
7/24/2022,Jeff Davis,Georgia,13161,4016,74,4090
7/24/2022,Jefferson,Georgia,13163,3820,113,3933
7/24/2022,Jenkins,Georgia,13165,1587,68,1655
7/24/2022,Johnson,Georgia,13167,2345,74,2419
7/24/2022,Jones,Georgia,13169,5419,109,5528
7/24/2022,Lamar,Georgia,13171,5146,115,5261
7/24/2022,Lanier,Georgia,13173,2408,26,2434
7/24/2022,Laurens,Georgia,13175,14677,309,14986
7/24/2022,Lee,Georgia,13177,7911,106,8017
7/24/2022,Liberty,Georgia,13179,13320,153,13473
7/24/2022,Lincoln,Georgia,13181,1656,35,1691
7/24/2022,Long,Georgia,13183,2974,35,3009
7/24/2022,Lowndes,Georgia,13185,33189,400,33589
7/24/2022,Lumpkin,Georgia,13187,7739,133,7872
7/24/2022,Macon,Georgia,13193,2310,52,2362
7/24/2022,Madison,Georgia,13195,7249,113,7362
7/24/2022,Marion,Georgia,13197,1628,51,1679
7/24/2022,McDuffie,Georgia,13189,5420,105,5525
7/24/2022,McIntosh,Georgia,13191,2627,37,2664
7/24/2022,Meriwether,Georgia,13199,4820,147,4967
7/24/2022,Miller,Georgia,13201,1833,32,1865
7/24/2022,Mitchell,Georgia,13205,5626,119,5745
7/24/2022,Monroe,Georgia,13207,6365,175,6540
7/24/2022,Montgomery,Georgia,13209,2148,53,2201
7/24/2022,Morgan,Georgia,13211,4904,70,4974
7/24/2022,Murray,Georgia,13213,12069,192,12261
7/24/2022,Muscogee,Georgia,13215,40997,845,41842
7/24/2022,Newton,Georgia,13217,26639,464,27103
7/24/2022,Oconee,Georgia,13219,9327,107,9434
7/24/2022,Oglethorpe,Georgia,13221,3417,58,3475
7/24/2022,Paulding,Georgia,13223,41243,438,41681
7/24/2022,Peach,Georgia,13225,6847,137,6984
7/24/2022,Pickens,Georgia,13227,8908,171,9079
7/24/2022,Pierce,Georgia,13229,5914,133,6047
7/24/2022,Pike,Georgia,13231,5777,99,5876
7/24/2022,Polk,Georgia,13233,12482,199,12681
7/24/2022,Pulaski,Georgia,13235,2271,78,2349
7/24/2022,Putnam,Georgia,13237,4766,107,4873
7/24/2022,Quitman,Georgia,13239,458,4,462
7/24/2022,Rabun,Georgia,13241,3839,101,3940
7/24/2022,Randolph,Georgia,13243,1577,48,1625
7/24/2022,Richmond,Georgia,13245,53959,906,54865
7/24/2022,Rockdale,Georgia,13247,20563,329,20892
7/24/2022,Schley,Georgia,13249,1245,11,1256
7/24/2022,Screven,Georgia,13251,2817,70,2887
7/24/2022,Seminole,Georgia,13253,2280,30,2310
7/24/2022,Spalding,Georgia,13255,17112,426,17538
7/24/2022,Stephens,Georgia,13257,6595,167,6762
7/24/2022,Stewart,Georgia,13259,2847,35,2882
7/24/2022,Sumter,Georgia,13261,7384,171,7555
7/24/2022,Talbot,Georgia,13263,1228,33,1261
7/24/2022,Taliaferro,Georgia,13265,293,3,296
7/24/2022,Tattnall,Georgia,13267,5304,133,5437
7/24/2022,Taylor,Georgia,13269,2096,54,2150
7/24/2022,Telfair,Georgia,13271,3181,88,3269
7/24/2022,Terrell,Georgia,13273,2200,68,2268
7/24/2022,Thomas,Georgia,13275,12716,214,12930
7/24/2022,Tift,Georgia,13277,12292,224,12516
7/24/2022,Toombs,Georgia,13279,7386,206,7592
7/24/2022,Towns,Georgia,13281,2568,117,2685
7/24/2022,Treutlen,Georgia,13283,1713,64,1777
7/24/2022,Troup,Georgia,13285,16506,386,16892
7/24/2022,Turner,Georgia,13287,2755,63,2818
7/24/2022,Twiggs,Georgia,13289,1657,70,1727
7/24/2022,Union,Georgia,13291,5354,161,5515
7/24/2022,Unknown,Georgia,,12053,6,12059
7/24/2022,Upson,Georgia,13293,8336,240,8576
7/24/2022,Walker,Georgia,13295,18194,254,18448
7/24/2022,Walton,Georgia,13297,23316,435,23751
7/24/2022,Ware,Georgia,13299,10556,285,10841
7/24/2022,Warren,Georgia,13301,1137,30,1167
7/24/2022,Washington,Georgia,13303,4692,138,4830
7/24/2022,Wayne,Georgia,13305,8083,207,8290
7/24/2022,Webster,Georgia,13307,462,8,470
7/24/2022,Wheeler,Georgia,13309,1471,39,1510
7/24/2022,White,Georgia,13311,7259,167,7426
7/24/2022,Whitfield,Georgia,13313,35351,442,35793
7/24/2022,Wilcox,Georgia,13315,2105,71,2176
7/24/2022,Wilkes,Georgia,13317,2328,56,2384
7/24/2022,Wilkinson,Georgia,13319,2394,59,2453
7/24/2022,Worth,Georgia,13321,4967,120,5087
7/24/2022,Unknown,Guam,,55132,378,55510
7/24/2022,Hawaii,Hawaii,15001,35717,200,35917
7/24/2022,Honolulu,Hawaii,15003,223313,1153,224466
7/24/2022,Kalawao,Hawaii,15005,1,0,1
7/24/2022,Kauai,Hawaii,15007,16265,35,16300
7/24/2022,Maui,Hawaii,15009,38509,148,38657
7/24/2022,Unknown,Hawaii,,0,9,9
7/24/2022,Ada,Idaho,16001,145933,1040,146973
7/24/2022,Adams,Idaho,16003,746,15,761
7/24/2022,Bannock,Idaho,16005,22185,254,22439
7/24/2022,Bear Lake,Idaho,16007,1007,16,1023
7/24/2022,Benewah,Idaho,16009,2561,41,2602
7/24/2022,Bingham,Idaho,16011,10312,161,10473
7/24/2022,Blaine,Idaho,16013,6580,29,6609
7/24/2022,Boise,Idaho,16015,1190,14,1204
7/24/2022,Bonner,Idaho,16017,9439,190,9629
7/24/2022,Bonneville,Idaho,16019,32481,290,32771
7/24/2022,Boundary,Idaho,16021,2214,63,2277
7/24/2022,Butte,Idaho,16023,505,11,516
7/24/2022,Camas,Idaho,16025,165,2,167
7/24/2022,Canyon,Idaho,16027,64682,693,65375
7/24/2022,Caribou,Idaho,16029,1536,29,1565
7/24/2022,Cassia,Idaho,16031,5149,53,5202
7/24/2022,Clark,Idaho,16033,113,1,114
7/24/2022,Clearwater,Idaho,16035,2416,34,2450
7/24/2022,Custer,Idaho,16037,636,9,645
7/24/2022,Elmore,Idaho,16039,7921,70,7991
7/24/2022,Franklin,Idaho,16041,2444,29,2473
7/24/2022,Fremont,Idaho,16043,2274,28,2302
7/24/2022,Gem,Idaho,16045,3879,80,3959
7/24/2022,Gooding,Idaho,16047,3485,55,3540
7/24/2022,Idaho,Idaho,16049,3215,52,3267
7/24/2022,Jefferson,Idaho,16051,6297,65,6362
7/24/2022,Jerome,Idaho,16053,6410,64,6474
7/24/2022,Kootenai,Idaho,16055,44094,612,44706
7/24/2022,Latah,Idaho,16057,7197,51,7248
7/24/2022,Lemhi,Idaho,16059,1433,26,1459
7/24/2022,Lewis,Idaho,16061,1211,30,1241
7/24/2022,Lincoln,Idaho,16063,1151,15,1166
7/24/2022,Madison,Idaho,16065,13182,54,13236
7/24/2022,Minidoka,Idaho,16067,4401,65,4466
7/24/2022,Nez Perce,Idaho,16069,9487,150,9637
7/24/2022,Oneida,Idaho,16071,856,11,867
7/24/2022,Owyhee,Idaho,16073,2381,53,2434
7/24/2022,Payette,Idaho,16075,5918,87,6005
7/24/2022,Power,Idaho,16077,1546,21,1567
7/24/2022,Shoshone,Idaho,16079,2917,77,2994
7/24/2022,Teton,Idaho,16081,2815,9,2824
7/24/2022,Twin Falls,Idaho,16083,25766,298,26064
7/24/2022,Valley,Idaho,16085,2849,16,2865
7/24/2022,Washington,Idaho,16087,2492,57,2549
7/24/2022,Adams,Illinois,17001,24448,240,24688
7/24/2022,Alexander,Illinois,17003,1392,16,1408
7/24/2022,Bond,Illinois,17005,4700,37,4737
7/24/2022,Boone,Illinois,17007,15296,132,15428
7/24/2022,Brown,Illinois,17009,2546,21,2567
7/24/2022,Bureau,Illinois,17011,8980,141,9121
7/24/2022,Calhoun,Illinois,17013,1636,8,1644
7/24/2022,Carroll,Illinois,17015,4557,50,4607
7/24/2022,Cass,Illinois,17017,4963,44,5007
7/24/2022,Champaign,Illinois,17019,73634,300,73934
7/24/2022,Christian,Illinois,17021,11149,131,11280
7/24/2022,Clark,Illinois,17023,5203,60,5263
7/24/2022,Clay,Illinois,17025,5074,74,5148
7/24/2022,Clinton,Illinois,17027,12779,122,12901
7/24/2022,Coles,Illinois,17029,16442,176,16618
7/24/2022,Cook,Illinois,17031,1322776,15102,1337878
7/24/2022,Crawford,Illinois,17033,6725,61,6786
7/24/2022,Cumberland,Illinois,17035,3522,49,3571
7/24/2022,DeKalb,Illinois,17037,27252,206,27458
7/24/2022,De Witt,Illinois,17039,4749,47,4796
7/24/2022,Douglas,Illinois,17041,6987,61,7048
7/24/2022,DuPage,Illinois,17043,249972,1831,251803
7/24/2022,Edgar,Illinois,17045,5611,80,5691
7/24/2022,Edwards,Illinois,17047,1862,29,1891
7/24/2022,Effingham,Illinois,17049,11399,150,11549
7/24/2022,Fayette,Illinois,17051,7629,104,7733
7/24/2022,Ford,Illinois,17053,4807,77,4884
7/24/2022,Franklin,Illinois,17055,13161,180,13341
7/24/2022,Fulton,Illinois,17057,11228,139,11367
7/24/2022,Gallatin,Illinois,17059,1539,19,1558
7/24/2022,Greene,Illinois,17061,3835,59,3894
7/24/2022,Grundy,Illinois,17063,14055,144,14199
7/24/2022,Hamilton,Illinois,17065,2319,34,2353
7/24/2022,Hancock,Illinois,17067,4720,58,4778
7/24/2022,Hardin,Illinois,17069,1134,20,1154
7/24/2022,Henderson,Illinois,17071,1279,28,1307
7/24/2022,Henry,Illinois,17073,13761,150,13911
7/24/2022,Iroquois,Illinois,17075,7815,120,7935
7/24/2022,Jackson,Illinois,17077,17460,135,17595
7/24/2022,Jasper,Illinois,17079,2826,33,2859
7/24/2022,Jefferson,Illinois,17081,11814,177,11991
7/24/2022,Jersey,Illinois,17083,6799,92,6891
7/24/2022,Jo Daviess,Illinois,17085,4451,40,4491
7/24/2022,Johnson,Illinois,17087,4807,47,4854
7/24/2022,Kane,Illinois,17089,143749,1196,144945
7/24/2022,Kankakee,Illinois,17091,31844,381,32225
7/24/2022,Kendall,Illinois,17093,36106,173,36279
7/24/2022,Knox,Illinois,17095,14003,251,14254
7/24/2022,Lake,Illinois,17097,178418,1494,179912
7/24/2022,LaSalle,Illinois,17099,32286,448,32734
7/24/2022,Lawrence,Illinois,17101,5802,52,5854
7/24/2022,Lee,Illinois,17103,9852,119,9971
7/24/2022,Livingston,Illinois,17105,11701,148,11849
7/24/2022,Logan,Illinois,17107,10939,105,11044
7/24/2022,Macon,Illinois,17115,34317,361,34678
7/24/2022,Macoupin,Illinois,17117,13921,171,14092
7/24/2022,Madison,Illinois,17119,77756,875,78631
7/24/2022,Marion,Illinois,17121,12705,217,12922
7/24/2022,Marshall,Illinois,17123,3082,33,3115
7/24/2022,Mason,Illinois,17125,4279,63,4342
7/24/2022,Massac,Illinois,17127,4140,74,4214
7/24/2022,McDonough,Illinois,17109,7916,110,8026
7/24/2022,McHenry,Illinois,17111,85845,517,86362
7/24/2022,McLean,Illinois,17113,57257,338,57595
7/24/2022,Menard,Illinois,17129,3927,26,3953
7/24/2022,Mercer,Illinois,17131,4373,50,4423
7/24/2022,Monroe,Illinois,17133,10239,131,10370
7/24/2022,Montgomery,Illinois,17135,10481,111,10592
7/24/2022,Morgan,Illinois,17137,10560,146,10706
7/24/2022,Moultrie,Illinois,17139,4342,54,4396
7/24/2022,Ogle,Illinois,17141,15271,136,15407
7/24/2022,Peoria,Illinois,17143,53038,547,53585
7/24/2022,Perry,Illinois,17145,7924,106,8030
7/24/2022,Piatt,Illinois,17147,4907,29,4936
7/24/2022,Pike,Illinois,17149,5371,71,5442
7/24/2022,Pope,Illinois,17151,1025,9,1034
7/24/2022,Pulaski,Illinois,17153,1835,21,1856
7/24/2022,Putnam,Illinois,17155,1251,10,1261
7/24/2022,Randolph,Illinois,17157,11193,136,11329
7/24/2022,Richland,Illinois,17159,5509,83,5592
7/24/2022,Rock Island,Illinois,17161,36751,531,37282
7/24/2022,Saline,Illinois,17165,8606,113,8719
7/24/2022,Sangamon,Illinois,17167,64481,446,64927
7/24/2022,Schuyler,Illinois,17169,2180,29,2209
7/24/2022,Scott,Illinois,17171,1370,12,1382
7/24/2022,Shelby,Illinois,17173,6645,80,6725
7/24/2022,Stark,Illinois,17175,1648,37,1685
7/24/2022,St. Clair,Illinois,17163,77413,787,78200
7/24/2022,Stephenson,Illinois,17177,12795,186,12981
7/24/2022,Tazewell,Illinois,17179,41068,515,41583
7/24/2022,Union,Illinois,17181,5889,70,5959
7/24/2022,Unknown,Illinois,,0,2594,2594
7/24/2022,Vermilion,Illinois,17183,30595,314,30909
7/24/2022,Wabash,Illinois,17185,4026,31,4057
7/24/2022,Warren,Illinois,17187,4398,89,4487
7/24/2022,Washington,Illinois,17189,3642,42,3684
7/24/2022,Wayne,Illinois,17191,5698,85,5783
7/24/2022,White,Illinois,17193,4651,59,4710
7/24/2022,Whiteside,Illinois,17195,16989,272,17261
7/24/2022,Will,Illinois,17197,187025,1645,188670
7/24/2022,Williamson,Illinois,17199,24814,266,25080
7/24/2022,Winnebago,Illinois,17201,86230,868,87098
7/24/2022,Woodford,Illinois,17203,11333,125,11458
7/24/2022,Adams,Indiana,18001,7631,117,7748
7/24/2022,Allen,Indiana,18003,109895,1205,111100
7/24/2022,Bartholomew,Indiana,18005,23074,251,23325
7/24/2022,Benton,Indiana,18007,2610,23,2633
7/24/2022,Blackford,Indiana,18009,3293,69,3362
7/24/2022,Boone,Indiana,18011,16310,193,16503
7/24/2022,Brown,Indiana,18013,2751,62,2813
7/24/2022,Carroll,Indiana,18015,4450,70,4520
7/24/2022,Cass,Indiana,18017,12308,169,12477
7/24/2022,Clark,Indiana,18019,34554,403,34957
7/24/2022,Clay,Indiana,18021,7266,93,7359
7/24/2022,Clinton,Indiana,18023,9667,133,9800
7/24/2022,Crawford,Indiana,18025,2700,41,2741
7/24/2022,Daviess,Indiana,18027,7792,155,7947
7/24/2022,Dearborn,Indiana,18029,14253,142,14395
7/24/2022,Decatur,Indiana,18031,7376,148,7524
7/24/2022,DeKalb,Indiana,18033,11940,154,12094
7/24/2022,Delaware,Indiana,18035,26612,456,27068
7/24/2022,Dubois,Indiana,18037,13338,165,13503
7/24/2022,Elkhart,Indiana,18039,56119,745,56864
7/24/2022,Fayette,Indiana,18041,7122,150,7272
7/24/2022,Floyd,Indiana,18043,20825,308,21133
7/24/2022,Fountain,Indiana,18045,5771,105,5876
7/24/2022,Franklin,Indiana,18047,4556,67,4623
7/24/2022,Fulton,Indiana,18049,5109,106,5215
7/24/2022,Gibson,Indiana,18051,12474,150,12624
7/24/2022,Grant,Indiana,18053,18317,362,18679
7/24/2022,Greene,Indiana,18055,7772,143,7915
7/24/2022,Hamilton,Indiana,18057,88738,678,89416
7/24/2022,Hancock,Indiana,18059,22129,266,22395
7/24/2022,Harrison,Indiana,18061,11608,141,11749
7/24/2022,Hendricks,Indiana,18063,43314,562,43876
7/24/2022,Henry,Indiana,18065,13910,234,14144
7/24/2022,Howard,Indiana,18067,26704,454,27158
7/24/2022,Huntington,Indiana,18069,12246,158,12404
7/24/2022,Jackson,Indiana,18071,13272,134,13406
7/24/2022,Jasper,Indiana,18073,9694,150,9844
7/24/2022,Jay,Indiana,18075,5099,78,5177
7/24/2022,Jefferson,Indiana,18077,9683,163,9846
7/24/2022,Jennings,Indiana,18079,7240,111,7351
7/24/2022,Johnson,Indiana,18081,45076,622,45698
7/24/2022,Knox,Indiana,18083,11656,154,11810
7/24/2022,Kosciusko,Indiana,18085,20637,238,20875
7/24/2022,LaGrange,Indiana,18087,5987,103,6090
7/24/2022,Lake,Indiana,18089,116864,1860,118724
7/24/2022,LaPorte,Indiana,18091,27796,375,28171
7/24/2022,Lawrence,Indiana,18093,12926,266,13192
7/24/2022,Madison,Indiana,18095,34681,661,35342
7/24/2022,Marion,Indiana,18097,240870,3032,243902
7/24/2022,Marshall,Indiana,18099,12800,199,12999
7/24/2022,Martin,Indiana,18101,2269,25,2294
7/24/2022,Miami,Indiana,18103,9639,162,9801
7/24/2022,Monroe,Indiana,18105,30936,286,31222
7/24/2022,Montgomery,Indiana,18107,11207,166,11373
7/24/2022,Morgan,Indiana,18109,17516,292,17808
7/24/2022,Newton,Indiana,18111,2769,69,2838
7/24/2022,Noble,Indiana,18113,13788,162,13950
7/24/2022,Ohio,Indiana,18115,1526,19,1545
7/24/2022,Orange,Indiana,18117,5329,99,5428
7/24/2022,Owen,Indiana,18119,6257,126,6383
7/24/2022,Parke,Indiana,18121,3759,47,3806
7/24/2022,Perry,Indiana,18123,4929,69,4998
7/24/2022,Pike,Indiana,18125,3958,50,4008
7/24/2022,Porter,Indiana,18127,41596,576,42172
7/24/2022,Posey,Indiana,18129,6982,58,7040
7/24/2022,Pulaski,Indiana,18131,3170,86,3256
7/24/2022,Putnam,Indiana,18133,9848,130,9978
7/24/2022,Randolph,Indiana,18135,6177,149,6326
7/24/2022,Ripley,Indiana,18137,8729,139,8868
7/24/2022,Rush,Indiana,18139,5138,59,5197
7/24/2022,Scott,Indiana,18143,8354,109,8463
7/24/2022,Shelby,Indiana,18145,14584,184,14768
7/24/2022,Spencer,Indiana,18147,5479,61,5540
7/24/2022,Starke,Indiana,18149,4979,101,5080
7/24/2022,Steuben,Indiana,18151,10142,122,10264
7/24/2022,St. Joseph,Indiana,18141,75733,889,76622
7/24/2022,Sullivan,Indiana,18153,5571,77,5648
7/24/2022,Switzerland,Indiana,18155,2357,20,2377
7/24/2022,Tippecanoe,Indiana,18157,54915,413,55328
7/24/2022,Tipton,Indiana,18159,3680,88,3768
7/24/2022,Union,Indiana,18161,2108,22,2130
7/24/2022,Unknown,Indiana,,0,38,38
7/24/2022,Vanderburgh,Indiana,18163,61884,642,62526
7/24/2022,Vermillion,Indiana,18165,4408,80,4488
7/24/2022,Vigo,Indiana,18167,30760,416,31176
7/24/2022,Wabash,Indiana,18169,9147,160,9307
7/24/2022,Warren,Indiana,18171,2175,30,2205
7/24/2022,Warrick,Indiana,18173,21866,242,22108
7/24/2022,Washington,Indiana,18175,6289,87,6376
7/24/2022,Wayne,Indiana,18177,20188,340,20528
7/24/2022,Wells,Indiana,18179,6771,134,6905
7/24/2022,White,Indiana,18181,7302,97,7399
7/24/2022,Whitley,Indiana,18183,10129,85,10214
7/24/2022,Adair,Iowa,19001,1639,51,1690
7/24/2022,Adams,Iowa,19003,842,14,856
7/24/2022,Allamakee,Iowa,19005,2963,60,3023
7/24/2022,Appanoose,Iowa,19007,3028,70,3098
7/24/2022,Audubon,Iowa,19009,1154,21,1175
7/24/2022,Benton,Iowa,19011,6420,80,6500
7/24/2022,Black Hawk,Iowa,19013,34885,494,35379
7/24/2022,Boone,Iowa,19015,5825,58,5883
7/24/2022,Bremer,Iowa,19017,5829,84,5913
7/24/2022,Buchanan,Iowa,19019,4900,60,4960
7/24/2022,Buena Vista,Iowa,19021,6497,58,6555
7/24/2022,Butler,Iowa,19023,3407,54,3461
7/24/2022,Calhoun,Iowa,19025,2749,25,2774
7/24/2022,Carroll,Iowa,19027,5200,72,5272
7/24/2022,Cass,Iowa,19029,3035,78,3113
7/24/2022,Cedar,Iowa,19031,4455,37,4492
7/24/2022,Cerro Gordo,Iowa,19033,11649,171,11820
7/24/2022,Cherokee,Iowa,19035,3127,66,3193
7/24/2022,Chickasaw,Iowa,19037,2840,32,2872
7/24/2022,Clarke,Iowa,19039,2377,37,2414
7/24/2022,Clay,Iowa,19041,4285,45,4330
7/24/2022,Clayton,Iowa,19043,3660,74,3734
7/24/2022,Clinton,Iowa,19045,12243,147,12390
7/24/2022,Crawford,Iowa,19047,4611,54,4665
7/24/2022,Dallas,Iowa,19049,24643,149,24792
7/24/2022,Davis,Iowa,19051,1674,34,1708
7/24/2022,Decatur,Iowa,19053,1600,26,1626
7/24/2022,Delaware,Iowa,19055,4245,68,4313
7/24/2022,Des Moines,Iowa,19057,9761,142,9903
7/24/2022,Dickinson,Iowa,19059,4297,75,4372
7/24/2022,Dubuque,Iowa,19061,27954,301,28255
7/24/2022,Emmet,Iowa,19063,2437,54,2491
7/24/2022,Fayette,Iowa,19065,4330,77,4407
7/24/2022,Floyd,Iowa,19067,3789,62,3851
7/24/2022,Franklin,Iowa,19069,2652,43,2695
7/24/2022,Fremont,Iowa,19071,1452,26,1478
7/24/2022,Greene,Iowa,19073,1819,22,1841
7/24/2022,Grundy,Iowa,19075,2683,45,2728
7/24/2022,Guthrie,Iowa,19077,2471,47,2518
7/24/2022,Hamilton,Iowa,19079,3612,74,3686
7/24/2022,Hancock,Iowa,19081,3004,48,3052
7/24/2022,Hardin,Iowa,19083,4382,63,4445
7/24/2022,Harrison,Iowa,19085,3539,95,3634
7/24/2022,Henry,Iowa,19087,5817,77,5894
7/24/2022,Howard,Iowa,19089,2146,36,2182
7/24/2022,Humboldt,Iowa,19091,2752,38,2790
7/24/2022,Ida,Iowa,19093,1879,49,1928
7/24/2022,Iowa,Iowa,19095,3909,50,3959
7/24/2022,Jackson,Iowa,19097,4936,71,5007
7/24/2022,Jasper,Iowa,19099,9247,112,9359
7/24/2022,Jefferson,Iowa,19101,3722,52,3774
7/24/2022,Johnson,Iowa,19103,39397,155,39552
7/24/2022,Jones,Iowa,19105,5829,74,5903
7/24/2022,Keokuk,Iowa,19107,2157,48,2205
7/24/2022,Kossuth,Iowa,19109,3962,89,4051
7/24/2022,Lee,Iowa,19111,8161,143,8304
7/24/2022,Linn,Iowa,19113,57003,599,57602
7/24/2022,Louisa,Iowa,19115,2638,63,2701
7/24/2022,Lucas,Iowa,19117,1857,32,1889
7/24/2022,Lyon,Iowa,19119,2841,52,2893
7/24/2022,Madison,Iowa,19121,3305,41,3346
7/24/2022,Mahaska,Iowa,19123,5179,90,5269
7/24/2022,Marion,Iowa,19125,7958,127,8085
7/24/2022,Marshall,Iowa,19127,10019,113,10132
7/24/2022,Mills,Iowa,19129,3575,44,3619
7/24/2022,Mitchell,Iowa,19131,2598,49,2647
7/24/2022,Monona,Iowa,19133,1802,49,1851
7/24/2022,Monroe,Iowa,19135,1968,49,2017
7/24/2022,Montgomery,Iowa,19137,2310,56,2366
7/24/2022,Muscatine,Iowa,19139,10186,132,10318
7/24/2022,O'Brien,Iowa,19141,3562,72,3634
7/24/2022,Osceola,Iowa,19143,1421,22,1443
7/24/2022,Page,Iowa,19145,3449,49,3498
7/24/2022,Palo Alto,Iowa,19147,2127,38,2165
7/24/2022,Plymouth,Iowa,19149,6514,104,6618
7/24/2022,Pocahontas,Iowa,19151,1697,27,1724
7/24/2022,Polk,Iowa,19153,134107,1126,135233
7/24/2022,Pottawattamie,Iowa,19155,25416,321,25737
7/24/2022,Poweshiek,Iowa,19157,4022,63,4085
7/24/2022,Ringgold,Iowa,19159,1164,35,1199
7/24/2022,Sac,Iowa,19161,2532,36,2568
7/24/2022,Scott,Iowa,19163,44059,404,44463
7/24/2022,Shelby,Iowa,19165,2849,52,2901
7/24/2022,Sioux,Iowa,19167,8216,89,8305
7/24/2022,Story,Iowa,19169,21099,92,21191
7/24/2022,Tama,Iowa,19171,4144,95,4239
7/24/2022,Taylor,Iowa,19173,1359,22,1381
7/24/2022,Union,Iowa,19175,2840,53,2893
7/24/2022,Unknown,Iowa,,568,0,568
7/24/2022,Van Buren,Iowa,19177,1462,27,1489
7/24/2022,Wapello,Iowa,19179,9425,209,9634
7/24/2022,Warren,Iowa,19181,13217,137,13354
7/24/2022,Washington,Iowa,19183,5970,79,6049
7/24/2022,Wayne,Iowa,19185,1342,33,1375
7/24/2022,Webster,Iowa,19187,10876,166,11042
7/24/2022,Winnebago,Iowa,19189,3126,47,3173
7/24/2022,Winneshiek,Iowa,19191,4091,52,4143
7/24/2022,Woodbury,Iowa,19193,29868,342,30210
7/24/2022,Worth,Iowa,19195,1850,17,1867
7/24/2022,Wright,Iowa,19197,3738,67,3805
7/24/2022,Allen,Kansas,20001,4295,57,4352
7/24/2022,Anderson,Kansas,20003,2257,35,2292
7/24/2022,Atchison,Kansas,20005,4548,39,4587
7/24/2022,Barber,Kansas,20007,1075,9,1084
7/24/2022,Barton,Kansas,20009,6736,107,6843
7/24/2022,Bourbon,Kansas,20011,4768,56,4824
7/24/2022,Brown,Kansas,20013,2854,49,2903
7/24/2022,Butler,Kansas,20015,19990,200,20190
7/24/2022,Chase,Kansas,20017,698,7,705
7/24/2022,Chautauqua,Kansas,20019,876,18,894
7/24/2022,Cherokee,Kansas,20021,6517,89,6606
7/24/2022,Cheyenne,Kansas,20023,668,14,682
7/24/2022,Clark,Kansas,20025,518,8,526
7/24/2022,Clay,Kansas,20027,2075,38,2113
7/24/2022,Cloud,Kansas,20029,2333,42,2375
7/24/2022,Coffey,Kansas,20031,2520,45,2565
7/24/2022,Comanche,Kansas,20033,452,17,469
7/24/2022,Cowley,Kansas,20035,10714,163,10877
7/24/2022,Crawford,Kansas,20037,12820,134,12954
7/24/2022,Decatur,Kansas,20039,638,20,658
7/24/2022,Dickinson,Kansas,20041,5091,87,5178
7/24/2022,Doniphan,Kansas,20043,2566,34,2600
7/24/2022,Douglas,Kansas,20045,29986,143,30129
7/24/2022,Edwards,Kansas,20047,574,13,587
7/24/2022,Elk,Kansas,20049,590,12,602
7/24/2022,Ellis,Kansas,20051,7437,86,7523
7/24/2022,Ellsworth,Kansas,20053,2085,32,2117
7/24/2022,Finney,Kansas,20055,12087,117,12204
7/24/2022,Ford,Kansas,20057,11104,117,11221
7/24/2022,Franklin,Kansas,20059,7318,93,7411
7/24/2022,Geary,Kansas,20061,9792,77,9869
7/24/2022,Gove,Kansas,20063,831,23,854
7/24/2022,Graham,Kansas,20065,605,15,620
7/24/2022,Grant,Kansas,20067,2371,37,2408
7/24/2022,Gray,Kansas,20069,1252,23,1275
7/24/2022,Greeley,Kansas,20071,340,3,343
7/24/2022,Greenwood,Kansas,20073,1879,26,1905
7/24/2022,Hamilton,Kansas,20075,484,4,488
7/24/2022,Harper,Kansas,20077,1707,28,1735
7/24/2022,Harvey,Kansas,20079,10246,125,10371
7/24/2022,Haskell,Kansas,20081,989,12,1001
7/24/2022,Hodgeman,Kansas,20083,425,11,436
7/24/2022,Jackson,Kansas,20085,4109,31,4140
7/24/2022,Jefferson,Kansas,20087,5100,68,5168
7/24/2022,Jewell,Kansas,20089,828,15,843
7/24/2022,Johnson,Kansas,20091,160428,1249,161677
7/24/2022,Kearny,Kansas,20093,1285,21,1306
7/24/2022,Kingman,Kansas,20095,2074,28,2102
7/24/2022,Kiowa,Kansas,20097,693,7,700
7/24/2022,Labette,Kansas,20099,6970,80,7050
7/24/2022,Lane,Kansas,20101,308,12,320
7/24/2022,Leavenworth,Kansas,20103,21027,198,21225
7/24/2022,Lincoln,Kansas,20105,642,11,653
7/24/2022,Linn,Kansas,20107,2992,32,3024
7/24/2022,Logan,Kansas,20109,880,13,893
7/24/2022,Lyon,Kansas,20111,10574,125,10699
7/24/2022,Marion,Kansas,20115,3472,46,3518
7/24/2022,Marshall,Kansas,20117,2635,44,2679
7/24/2022,McPherson,Kansas,20113,8271,130,8401
7/24/2022,Meade,Kansas,20119,1246,22,1268
7/24/2022,Miami,Kansas,20121,8414,100,8514
7/24/2022,Mitchell,Kansas,20123,1499,24,1523
7/24/2022,Montgomery,Kansas,20125,9808,166,9974
7/24/2022,Morris,Kansas,20127,1578,30,1608
7/24/2022,Morton,Kansas,20129,640,12,652
7/24/2022,Nemaha,Kansas,20131,3389,60,3449
7/24/2022,Neosho,Kansas,20133,5457,69,5526
7/24/2022,Ness,Kansas,20135,797,19,816
7/24/2022,Norton,Kansas,20137,2173,36,2209
7/24/2022,Osage,Kansas,20139,4174,61,4235
7/24/2022,Osborne,Kansas,20141,846,19,865
7/24/2022,Ottawa,Kansas,20143,1256,23,1279
7/24/2022,Pawnee,Kansas,20145,2278,24,2302
7/24/2022,Phillips,Kansas,20147,1397,30,1427
7/24/2022,Pottawatomie,Kansas,20149,6145,62,6207
7/24/2022,Pratt,Kansas,20151,2014,35,2049
7/24/2022,Rawlins,Kansas,20153,695,9,704
7/24/2022,Reno,Kansas,20155,19761,245,20006
7/24/2022,Republic,Kansas,20157,1384,19,1403
7/24/2022,Rice,Kansas,20159,2748,27,2775
7/24/2022,Riley,Kansas,20161,14441,90,14531
7/24/2022,Rooks,Kansas,20163,1408,21,1429
7/24/2022,Rush,Kansas,20165,831,19,850
7/24/2022,Russell,Kansas,20167,1916,38,1954
7/24/2022,Saline,Kansas,20169,14919,252,15171
7/24/2022,Scott,Kansas,20171,1358,34,1392
7/24/2022,Sedgwick,Kansas,20173,152962,1478,154440
7/24/2022,Seward,Kansas,20175,7199,63,7262
7/24/2022,Shawnee,Kansas,20177,52566,650,53216
7/24/2022,Sheridan,Kansas,20179,801,17,818
7/24/2022,Sherman,Kansas,20181,1562,22,1584
7/24/2022,Smith,Kansas,20183,657,9,666
7/24/2022,Stafford,Kansas,20185,1193,28,1221
7/24/2022,Stanton,Kansas,20187,442,9,451
7/24/2022,Stevens,Kansas,20189,1623,23,1646
7/24/2022,Sumner,Kansas,20191,5926,76,6002
7/24/2022,Thomas,Kansas,20193,2591,29,2620
7/24/2022,Trego,Kansas,20195,802,12,814
7/24/2022,Wabaunsee,Kansas,20197,1717,23,1740
7/24/2022,Wallace,Kansas,20199,455,7,462
7/24/2022,Washington,Kansas,20201,1450,23,1473
7/24/2022,Wichita,Kansas,20203,550,8,558
7/24/2022,Wilson,Kansas,20205,2959,50,3009
7/24/2022,Woodson,Kansas,20207,856,17,873
7/24/2022,Wyandotte,Kansas,20209,49908,521,50429
7/24/2022,Adair,Kentucky,21001,6284,110,6394
7/24/2022,Allen,Kentucky,21003,7008,111,7119
7/24/2022,Anderson,Kentucky,21005,7111,71,7182
7/24/2022,Ballard,Kentucky,21007,1548,34,1582
7/24/2022,Barren,Kentucky,21009,13847,222,14069
7/24/2022,Bath,Kentucky,21011,3459,49,3508
7/24/2022,Bell,Kentucky,21013,9216,160,9376
7/24/2022,Boone,Kentucky,21015,42937,309,43246
7/24/2022,Bourbon,Kentucky,21017,6525,61,6586
7/24/2022,Boyd,Kentucky,21019,17881,183,18064
7/24/2022,Boyle,Kentucky,21021,9483,139,9622
7/24/2022,Bracken,Kentucky,21023,2358,27,2385
7/24/2022,Breathitt,Kentucky,21025,4170,56,4226
7/24/2022,Breckinridge,Kentucky,21027,5432,81,5513
7/24/2022,Bullitt,Kentucky,21029,23766,230,23996
7/24/2022,Butler,Kentucky,21031,4015,55,4070
7/24/2022,Caldwell,Kentucky,21033,4382,63,4445
7/24/2022,Calloway,Kentucky,21035,9731,98,9829
7/24/2022,Campbell,Kentucky,21037,27027,187,27214
7/24/2022,Carlisle,Kentucky,21039,1157,20,1177
7/24/2022,Carroll,Kentucky,21041,3655,48,3703
7/24/2022,Carter,Kentucky,21043,9409,109,9518
7/24/2022,Casey,Kentucky,21045,4381,76,4457
7/24/2022,Christian,Kentucky,21047,17382,215,17597
7/24/2022,Clark,Kentucky,21049,11743,73,11816
7/24/2022,Clay,Kentucky,21051,8105,97,8202
7/24/2022,Clinton,Kentucky,21053,3859,53,3912
7/24/2022,Crittenden,Kentucky,21055,2465,51,2516
7/24/2022,Cumberland,Kentucky,21057,2316,33,2349
7/24/2022,Daviess,Kentucky,21059,33036,395,33431
7/24/2022,Edmonson,Kentucky,21061,2703,50,2753
7/24/2022,Elliott,Kentucky,21063,2817,20,2837
7/24/2022,Estill,Kentucky,21065,4293,52,4345
7/24/2022,Fayette,Kentucky,21067,104481,629,105110
7/24/2022,Fleming,Kentucky,21069,4227,63,4290
7/24/2022,Floyd,Kentucky,21071,13311,222,13533
7/24/2022,Franklin,Kentucky,21073,15218,159,15377
7/24/2022,Fulton,Kentucky,21075,1291,33,1324
7/24/2022,Gallatin,Kentucky,21077,2320,52,2372
7/24/2022,Garrard,Kentucky,21079,5080,80,5160
7/24/2022,Grant,Kentucky,21081,8456,68,8524
7/24/2022,Graves,Kentucky,21083,12025,186,12211
7/24/2022,Grayson,Kentucky,21085,8494,136,8630
7/24/2022,Green,Kentucky,21087,3914,46,3960
7/24/2022,Greenup,Kentucky,21089,13181,151,13332
7/24/2022,Hancock,Kentucky,21091,2649,26,2675
7/24/2022,Hardin,Kentucky,21093,35771,448,36219
7/24/2022,Harlan,Kentucky,21095,9671,216,9887
7/24/2022,Harrison,Kentucky,21097,7062,80,7142
7/24/2022,Hart,Kentucky,21099,5703,106,5809
7/24/2022,Henderson,Kentucky,21101,14764,174,14938
7/24/2022,Henry,Kentucky,21103,5347,53,5400
7/24/2022,Hickman,Kentucky,21105,938,28,966
7/24/2022,Hopkins,Kentucky,21107,15883,259,16142
7/24/2022,Jackson,Kentucky,21109,4447,82,4529
7/24/2022,Jefferson,Kentucky,21111,260235,2439,262674
7/24/2022,Jessamine,Kentucky,21113,16339,149,16488
7/24/2022,Johnson,Kentucky,21115,7060,125,7185
7/24/2022,Kenton,Kentucky,21117,49487,436,49923
7/24/2022,Knott,Kentucky,21119,4550,66,4616
7/24/2022,Knox,Kentucky,21121,12181,152,12333
7/24/2022,Larue,Kentucky,21123,4007,74,4081
7/24/2022,Laurel,Kentucky,21125,21605,252,21857
7/24/2022,Lawrence,Kentucky,21127,4772,73,4845
7/24/2022,Lee,Kentucky,21129,3010,56,3066
7/24/2022,Leslie,Kentucky,21131,3987,49,4036
7/24/2022,Letcher,Kentucky,21133,7577,119,7696
7/24/2022,Lewis,Kentucky,21135,4802,89,4891
7/24/2022,Lincoln,Kentucky,21137,7171,139,7310
7/24/2022,Livingston,Kentucky,21139,2678,61,2739
7/24/2022,Logan,Kentucky,21141,8808,129,8937
7/24/2022,Lyon,Kentucky,21143,3131,36,3167
7/24/2022,Madison,Kentucky,21151,29741,286,30027
7/24/2022,Magoffin,Kentucky,21153,4217,53,4270
7/24/2022,Marion,Kentucky,21155,6832,86,6918
7/24/2022,Marshall,Kentucky,21157,8881,117,8998
7/24/2022,Martin,Kentucky,21159,3495,49,3544
7/24/2022,Mason,Kentucky,21161,5323,108,5431
7/24/2022,McCracken,Kentucky,21145,21097,279,21376
7/24/2022,McCreary,Kentucky,21147,5917,84,6001
7/24/2022,McLean,Kentucky,21149,2774,53,2827
7/24/2022,Meade,Kentucky,21163,6196,66,6262
7/24/2022,Menifee,Kentucky,21165,1839,32,1871
7/24/2022,Mercer,Kentucky,21167,7913,108,8021
7/24/2022,Metcalfe,Kentucky,21169,3066,68,3134
7/24/2022,Monroe,Kentucky,21171,3834,80,3914
7/24/2022,Montgomery,Kentucky,21173,9415,110,9525
7/24/2022,Morgan,Kentucky,21175,5608,33,5641
7/24/2022,Muhlenberg,Kentucky,21177,10951,124,11075
7/24/2022,Nelson,Kentucky,21179,15592,157,15749
7/24/2022,Nicholas,Kentucky,21181,2271,32,2303
7/24/2022,Ohio,Kentucky,21183,7716,105,7821
7/24/2022,Oldham,Kentucky,21185,19849,146,19995
7/24/2022,Owen,Kentucky,21187,2536,34,2570
7/24/2022,Owsley,Kentucky,21189,1614,30,1644
7/24/2022,Pendleton,Kentucky,21191,3672,40,3712
7/24/2022,Perry,Kentucky,21193,11926,185,12111
7/24/2022,Pike,Kentucky,21195,20539,320,20859
7/24/2022,Powell,Kentucky,21197,5048,45,5093
7/24/2022,Pulaski,Kentucky,21199,19136,298,19434
7/24/2022,Robertson,Kentucky,21201,714,21,735
7/24/2022,Rockcastle,Kentucky,21203,5301,63,5364
7/24/2022,Rowan,Kentucky,21205,7354,73,7427
7/24/2022,Russell,Kentucky,21207,6789,88,6877
7/24/2022,Scott,Kentucky,21209,19395,115,19510
7/24/2022,Shelby,Kentucky,21211,14417,167,14584
7/24/2022,Simpson,Kentucky,21213,6065,96,6161
7/24/2022,Spencer,Kentucky,21215,5813,63,5876
7/24/2022,Taylor,Kentucky,21217,10085,129,10214
7/24/2022,Todd,Kentucky,21219,3091,46,3137
7/24/2022,Trigg,Kentucky,21221,4259,45,4304
7/24/2022,Trimble,Kentucky,21223,2298,42,2340
7/24/2022,Union,Kentucky,21225,4529,57,4586
7/24/2022,Warren,Kentucky,21227,45739,384,46123
7/24/2022,Washington,Kentucky,21229,4266,62,4328
7/24/2022,Wayne,Kentucky,21231,6408,93,6501
7/24/2022,Webster,Kentucky,21233,4136,50,4186
7/24/2022,Whitley,Kentucky,21235,14553,210,14763
7/24/2022,Wolfe,Kentucky,21237,2752,29,2781
7/24/2022,Woodford,Kentucky,21239,7703,53,7756
7/24/2022,Acadia,Louisiana,22001,17126,296,17422
7/24/2022,Allen,Louisiana,22003,8327,143,8470
7/24/2022,Ascension,Louisiana,22005,37919,295,38214
7/24/2022,Assumption,Louisiana,22007,6069,70,6139
7/24/2022,Avoyelles,Louisiana,22009,12668,212,12880
7/24/2022,Beauregard,Louisiana,22011,10009,142,10151
7/24/2022,Bienville,Louisiana,22013,4299,113,4412
7/24/2022,Bossier,Louisiana,22015,42835,499,43334
7/24/2022,Caddo,Louisiana,22017,74676,1164,75840
7/24/2022,Calcasieu,Louisiana,22019,59692,715,60407
7/24/2022,Caldwell,Louisiana,22021,3831,55,3886
7/24/2022,Cameron,Louisiana,22023,1267,8,1275
7/24/2022,Catahoula,Louisiana,22025,2856,57,2913
7/24/2022,Claiborne,Louisiana,22027,3500,79,3579
7/24/2022,Concordia,Louisiana,22029,5526,89,5615
7/24/2022,De Soto,Louisiana,22031,8303,135,8438
7/24/2022,East Baton Rouge,Louisiana,22033,122287,1362,123649
7/24/2022,East Carroll,Louisiana,22035,2739,38,2777
7/24/2022,East Feliciana,Louisiana,22037,7600,170,7770
7/24/2022,Evangeline,Louisiana,22039,9127,160,9287
7/24/2022,Franklin,Louisiana,22041,7804,178,7982
7/24/2022,Grant,Louisiana,22043,6368,95,6463
7/24/2022,Iberia,Louisiana,22045,21072,266,21338
7/24/2022,Iberville,Louisiana,22047,10205,153,10358
7/24/2022,Jackson,Louisiana,22049,4803,77,4880
7/24/2022,Jefferson,Louisiana,22051,126981,1363,128344
7/24/2022,Jefferson Davis,Louisiana,22053,7539,161,7700
7/24/2022,Lafayette,Louisiana,22055,68455,507,68962
7/24/2022,Lafourche,Louisiana,22057,30634,381,31015
7/24/2022,LaSalle,Louisiana,22059,4581,62,4643
7/24/2022,Lincoln,Louisiana,22061,13291,145,13436
7/24/2022,Livingston,Louisiana,22063,39771,474,40245
7/24/2022,Madison,Louisiana,22065,3443,58,3501
7/24/2022,Morehouse,Louisiana,22067,7532,134,7666
7/24/2022,Natchitoches,Louisiana,22069,11302,171,11473
7/24/2022,Orleans,Louisiana,22071,101117,1135,102252
7/24/2022,Ouachita,Louisiana,22073,54982,764,55746
7/24/2022,Plaquemines,Louisiana,22075,7073,46,7119
7/24/2022,Pointe Coupee,Louisiana,22077,6956,93,7049
7/24/2022,Rapides,Louisiana,22079,35833,582,36415
7/24/2022,Red River,Louisiana,22081,2264,54,2318
7/24/2022,Richland,Louisiana,22083,7386,100,7486
7/24/2022,Sabine,Louisiana,22085,6937,115,7052
7/24/2022,St. Bernard,Louisiana,22087,12570,114,12684
7/24/2022,St. Charles,Louisiana,22089,15328,144,15472
7/24/2022,St. Helena,Louisiana,22091,2035,24,2059
7/24/2022,St. James,Louisiana,22093,6460,76,6536
7/24/2022,St. John the Baptist,Louisiana,22095,11755,185,11940
7/24/2022,St. Landry,Louisiana,22097,24243,417,24660
7/24/2022,St. Martin,Louisiana,22099,13829,191,14020
7/24/2022,St. Mary,Louisiana,22101,13607,268,13875
7/24/2022,St. Tammany,Louisiana,22103,80340,866,81206
7/24/2022,Tangipahoa,Louisiana,22105,38503,615,39118
7/24/2022,Tensas,Louisiana,22107,1070,12,1082
7/24/2022,Terrebonne,Louisiana,22109,34483,424,34907
7/24/2022,Union,Louisiana,22111,7558,137,7695
7/24/2022,Unknown,Louisiana,,1086,0,1086
7/24/2022,Vermilion,Louisiana,22113,16731,226,16957
7/24/2022,Vernon,Louisiana,22115,10601,191,10792
7/24/2022,Washington,Louisiana,22117,14144,255,14399
7/24/2022,Webster,Louisiana,22119,12367,187,12554
7/24/2022,West Baton Rouge,Louisiana,22121,8008,91,8099
7/24/2022,West Carroll,Louisiana,22123,4011,67,4078
7/24/2022,West Feliciana,Louisiana,22125,3017,46,3063
7/24/2022,Winn,Louisiana,22127,4812,64,4876
7/24/2022,Androscoggin,Maine,23001,24656,294,24950
7/24/2022,Aroostook,Maine,23003,15680,180,15860
7/24/2022,Cumberland,Maine,23005,57602,392,57994
7/24/2022,Franklin,Maine,23007,6432,63,6495
7/24/2022,Hancock,Maine,23009,8718,93,8811
7/24/2022,Kennebec,Maine,23011,26318,253,26571
7/24/2022,Knox,Maine,23013,6922,40,6962
7/24/2022,Lincoln,Maine,23015,6021,38,6059
7/24/2022,Oxford,Maine,23017,12682,153,12835
7/24/2022,Penobscot,Maine,23019,31885,350,32235
7/24/2022,Piscataquis,Maine,23021,3314,34,3348
7/24/2022,Sagadahoc,Maine,23023,6000,37,6037
7/24/2022,Somerset,Maine,23025,10854,114,10968
7/24/2022,Unknown,Maine,,8,0,8
7/24/2022,Waldo,Maine,23027,6983,61,7044
7/24/2022,Washington,Maine,23029,4905,60,4965
7/24/2022,York,Maine,23031,45521,303,45824
7/24/2022,Allegany,Maryland,24001,18358,368,18726
7/24/2022,Anne Arundel,Maryland,24003,103256,1129,104385
7/24/2022,Baltimore,Maryland,24005,149128,2558,151686
7/24/2022,Baltimore city,Maryland,24510,128438,1830,130268
7/24/2022,Calvert,Maryland,24009,12686,150,12836
7/24/2022,Caroline,Maryland,24011,6505,81,6586
7/24/2022,Carroll,Maryland,24013,24217,418,24635
7/24/2022,Cecil,Maryland,24015,17349,263,17612
7/24/2022,Charles,Maryland,24017,32594,359,32953
7/24/2022,Dorchester,Maryland,24019,8366,110,8476
7/24/2022,Frederick,Maryland,24021,51099,536,51635
7/24/2022,Garrett,Maryland,24023,6174,115,6289
7/24/2022,Harford,Maryland,24025,43024,596,43620
7/24/2022,Howard,Maryland,24027,53663,390,54053
7/24/2022,Kent,Maryland,24029,3421,70,3491
7/24/2022,Montgomery,Maryland,24031,207259,2106,209365
7/24/2022,Prince George's,Maryland,24033,193812,2208,196020
7/24/2022,Queen Anne's,Maryland,24035,7796,115,7911
7/24/2022,Somerset,Maryland,24039,5522,76,5598
7/24/2022,St. Mary's,Maryland,24037,21126,221,21347
7/24/2022,Talbot,Maryland,24041,6181,92,6273
7/24/2022,Unknown,Maryland,,0,34,34
7/24/2022,Washington,Maryland,24043,37147,593,37740
7/24/2022,Wicomico,Maryland,24045,21529,333,21862
7/24/2022,Worcester,Maryland,24047,9540,161,9701
7/24/2022,Barnstable,Massachusetts,25001,41439,616,42055
7/24/2022,Berkshire,Massachusetts,25003,29550,398,29948
7/24/2022,Bristol,Massachusetts,25005,163556,2219,165775
7/24/2022,Dukes,Massachusetts,25007,3990,0,3990
7/24/2022,Essex,Massachusetts,25009,228487,2838,231325
7/24/2022,Franklin,Massachusetts,25011,12523,154,12677
7/24/2022,Hampden,Massachusetts,25013,149451,1867,151318
7/24/2022,Hampshire,Massachusetts,25015,34219,371,34590
7/24/2022,Middlesex,Massachusetts,25017,386716,4175,390891
7/24/2022,Nantucket,Massachusetts,25019,3639,0,3639
7/24/2022,Norfolk,Massachusetts,25021,153860,1980,155840
7/24/2022,Plymouth,Massachusetts,25023,127906,1747,129653
7/24/2022,Suffolk,Massachusetts,25025,242021,2055,244076
7/24/2022,Unknown,Massachusetts,,164066,25,164091
7/24/2022,Worcester,Massachusetts,25027,214421,2682,217103
7/24/2022,Alcona,Michigan,26001,1793,72,1865
7/24/2022,Alger,Michigan,26003,2021,14,2035
7/24/2022,Allegan,Michigan,26005,28995,364,29359
7/24/2022,Alpena,Michigan,26007,5948,142,6090
7/24/2022,Antrim,Michigan,26009,4762,70,4832
7/24/2022,Arenac,Michigan,26011,3446,71,3517
7/24/2022,Baraga,Michigan,26013,2385,56,2441
7/24/2022,Barry,Michigan,26015,15257,174,15431
7/24/2022,Bay,Michigan,26017,28856,604,29460
7/24/2022,Benzie,Michigan,26019,3741,71,3812
7/24/2022,Berrien,Michigan,26021,37381,588,37969
7/24/2022,Branch,Michigan,26023,12715,212,12927
7/24/2022,Calhoun,Michigan,26025,36960,597,37557
7/24/2022,Cass,Michigan,26027,11713,148,11861
7/24/2022,Charlevoix,Michigan,26029,5323,60,5383
7/24/2022,Cheboygan,Michigan,26031,5131,109,5240
7/24/2022,Chippewa,Michigan,26033,12316,122,12438
7/24/2022,Clare,Michigan,26035,7206,160,7366
7/24/2022,Clinton,Michigan,26037,23596,213,23809
7/24/2022,Crawford,Michigan,26039,2812,32,2844
7/24/2022,Delta,Michigan,26041,10750,162,10912
7/24/2022,Dickinson,Michigan,26043,7908,114,8022
7/24/2022,Eaton,Michigan,26045,29644,420,30064
7/24/2022,Emmet,Michigan,26047,6955,94,7049
7/24/2022,Genesee,Michigan,26049,110122,1802,111924
7/24/2022,Gladwin,Michigan,26051,5930,117,6047
7/24/2022,Gogebic,Michigan,26053,3641,71,3712
7/24/2022,Grand Traverse,Michigan,26055,19175,246,19421
7/24/2022,Gratiot,Michigan,26057,14456,196,14652
7/24/2022,Hillsdale,Michigan,26059,11083,206,11289
7/24/2022,Houghton,Michigan,26061,8512,99,8611
7/24/2022,Huron,Michigan,26063,8579,148,8727
7/24/2022,Ingham,Michigan,26065,71715,798,72513
7/24/2022,Ionia,Michigan,26067,20645,187,20832
7/24/2022,Iosco,Michigan,26069,5140,151,5291
7/24/2022,Iron,Michigan,26071,2888,88,2976
7/24/2022,Isabella,Michigan,26073,16558,221,16779
7/24/2022,Jackson,Michigan,26075,48182,608,48790
7/24/2022,Kalamazoo,Michigan,26077,65975,698,66673
7/24/2022,Kalkaska,Michigan,26079,3955,62,4017
7/24/2022,Kent,Michigan,26081,181162,1589,182751
7/24/2022,Keweenaw,Michigan,26083,578,13,591
7/24/2022,Lake,Michigan,26085,2051,39,2090
7/24/2022,Lapeer,Michigan,26087,22039,433,22472
7/24/2022,Leelanau,Michigan,26089,3980,59,4039
7/24/2022,Lenawee,Michigan,26091,28112,337,28449
7/24/2022,Livingston,Michigan,26093,50727,473,51200
7/24/2022,Luce,Michigan,26095,2385,17,2402
7/24/2022,Mackinac,Michigan,26097,2676,31,2707
7/24/2022,Macomb,Michigan,26099,257054,4101,261155
7/24/2022,Manistee,Michigan,26101,4826,95,4921
7/24/2022,Marquette,Michigan,26103,17607,141,17748
7/24/2022,Mason,Michigan,26105,7320,96,7416
7/24/2022,Mecosta,Michigan,26107,9263,113,9376
7/24/2022,Menominee,Michigan,26109,6019,73,6092
7/24/2022,Midland,Michigan,26111,20717,234,20951
7/24/2022,Missaukee,Michigan,26113,3116,63,3179
7/24/2022,Monroe,Michigan,26115,41872,486,42358
7/24/2022,Montcalm,Michigan,26117,18104,223,18327
7/24/2022,Montmorency,Michigan,26119,1811,48,1859
7/24/2022,Muskegon,Michigan,26121,44958,662,45620
7/24/2022,Newaygo,Michigan,26123,12190,161,12351
7/24/2022,Oakland,Michigan,26125,329041,3985,333026
7/24/2022,Oceana,Michigan,26127,6807,92,6899
7/24/2022,Ogemaw,Michigan,26129,4549,109,4658
7/24/2022,Ontonagon,Michigan,26131,1088,40,1128
7/24/2022,Osceola,Michigan,26133,5371,84,5455
7/24/2022,Oscoda,Michigan,26135,1533,57,1590
7/24/2022,Otsego,Michigan,26137,6120,104,6224
7/24/2022,Ottawa,Michigan,26139,80160,811,80971
7/24/2022,Presque Isle,Michigan,26141,2200,61,2261
7/24/2022,Roscommon,Michigan,26143,4980,120,5100
7/24/2022,Saginaw,Michigan,26145,54660,979,55639
7/24/2022,Sanilac,Michigan,26151,9202,203,9405
7/24/2022,Schoolcraft,Michigan,26153,1900,16,1916
7/24/2022,Shiawassee,Michigan,26155,19177,233,19410
7/24/2022,St. Clair,Michigan,26147,43831,846,44677
7/24/2022,St. Joseph,Michigan,26149,14320,211,14531
7/24/2022,Tuscola,Michigan,26157,13931,288,14219
7/24/2022,Unknown,Michigan,,19439,82,19521
7/24/2022,Van Buren,Michigan,26159,18324,282,18606
7/24/2022,Washtenaw,Michigan,26161,93781,550,94331
7/24/2022,Wayne,Michigan,26163,451861,8172,460033
7/24/2022,Wexford,Michigan,26165,7647,112,7759
7/24/2022,Aitkin,Minnesota,27001,3245,63,3308
7/24/2022,Anoka,Minnesota,27003,106864,813,107677
7/24/2022,Becker,Minnesota,27005,9388,98,9486
7/24/2022,Beltrami,Minnesota,27007,12692,128,12820
7/24/2022,Benton,Minnesota,27009,15147,180,15327
7/24/2022,Big Stone,Minnesota,27011,1482,9,1491
7/24/2022,Blue Earth,Minnesota,27013,19262,105,19367
7/24/2022,Brown,Minnesota,27015,6951,81,7032
7/24/2022,Carlton,Minnesota,27017,9992,103,10095
7/24/2022,Carver,Minnesota,27019,29188,121,29309
7/24/2022,Cass,Minnesota,27021,7556,84,7640
7/24/2022,Chippewa,Minnesota,27023,3312,49,3361
7/24/2022,Chisago,Minnesota,27025,15617,120,15737
7/24/2022,Clay,Minnesota,27027,21130,128,21258
7/24/2022,Clearwater,Minnesota,27029,2224,31,2255
7/24/2022,Cook,Minnesota,27031,673,4,677
7/24/2022,Cottonwood,Minnesota,27033,3370,41,3411
7/24/2022,Crow Wing,Minnesota,27035,17181,172,17353
7/24/2022,Dakota,Minnesota,27037,122071,803,122874
7/24/2022,Dodge,Minnesota,27039,6171,22,6193
7/24/2022,Douglas,Minnesota,27041,11720,120,11840
7/24/2022,Faribault,Minnesota,27043,4056,54,4110
7/24/2022,Fillmore,Minnesota,27045,5160,25,5185
7/24/2022,Freeborn,Minnesota,27047,9559,78,9637
7/24/2022,Goodhue,Minnesota,27049,14334,145,14479
7/24/2022,Grant,Minnesota,27051,1567,12,1579
7/24/2022,Hennepin,Minnesota,27053,341208,2648,343856
7/24/2022,Houston,Minnesota,27055,4944,20,4964
7/24/2022,Hubbard,Minnesota,27057,5280,60,5340
7/24/2022,Isanti,Minnesota,27059,10747,120,10867
7/24/2022,Itasca,Minnesota,27061,12085,150,12235
7/24/2022,Jackson,Minnesota,27063,2275,17,2292
7/24/2022,Kanabec,Minnesota,27065,3798,57,3855
7/24/2022,Kandiyohi,Minnesota,27067,14206,143,14349
7/24/2022,Kittson,Minnesota,27069,1097,29,1126
7/24/2022,Koochiching,Minnesota,27071,3132,39,3171
7/24/2022,Lac qui Parle,Minnesota,27073,1870,29,1899
7/24/2022,Lake,Minnesota,27075,2314,30,2344
7/24/2022,Lake of the Woods,Minnesota,27077,829,6,835
7/24/2022,Le Sueur,Minnesota,27079,6810,51,6861
7/24/2022,Lincoln,Minnesota,27081,1266,6,1272
7/24/2022,Lyon,Minnesota,27083,7379,74,7453
7/24/2022,Mahnomen,Minnesota,27087,1904,18,1922
7/24/2022,Marshall,Minnesota,27089,2198,24,2222
7/24/2022,Martin,Minnesota,27091,5937,65,6002
7/24/2022,McLeod,Minnesota,27085,11445,110,11555
7/24/2022,Meeker,Minnesota,27093,6317,78,6395
7/24/2022,Mille Lacs,Minnesota,27095,7665,117,7782
7/24/2022,Morrison,Minnesota,27097,9747,107,9854
7/24/2022,Mower,Minnesota,27099,12630,74,12704
7/24/2022,Murray,Minnesota,27101,2131,20,2151
7/24/2022,Nicollet,Minnesota,27103,8826,69,8895
7/24/2022,Nobles,Minnesota,27105,7206,60,7266
7/24/2022,Norman,Minnesota,27107,1595,14,1609
7/24/2022,Olmsted,Minnesota,27109,47198,194,47392
7/24/2022,Otter Tail,Minnesota,27111,14375,172,14547
7/24/2022,Pennington,Minnesota,27113,3824,41,3865
7/24/2022,Pine,Minnesota,27115,7615,68,7683
7/24/2022,Pipestone,Minnesota,27117,2079,34,2113
7/24/2022,Polk,Minnesota,27119,9388,111,9499
7/24/2022,Pope,Minnesota,27121,3403,20,3423
7/24/2022,Ramsey,Minnesota,27123,140136,1378,141514
7/24/2022,Red Lake,Minnesota,27125,974,13,987
7/24/2022,Redwood,Minnesota,27127,4172,54,4226
7/24/2022,Renville,Minnesota,27129,4007,58,4065
7/24/2022,Rice,Minnesota,27131,19121,189,19310
7/24/2022,Rock,Minnesota,27133,2461,35,2496
7/24/2022,Roseau,Minnesota,27135,4665,45,4710
7/24/2022,Scott,Minnesota,27139,43789,268,44057
7/24/2022,Sherburne,Minnesota,27141,28839,183,29022
7/24/2022,Sibley,Minnesota,27143,3773,26,3799
7/24/2022,Stearns,Minnesota,27145,54552,381,54933
7/24/2022,Steele,Minnesota,27147,11054,63,11117
7/24/2022,Stevens,Minnesota,27149,2886,14,2900
7/24/2022,St. Louis,Minnesota,27137,52966,555,53521
7/24/2022,Swift,Minnesota,27151,2415,33,2448
7/24/2022,Todd,Minnesota,27153,7249,61,7310
7/24/2022,Traverse,Minnesota,27155,906,11,917
7/24/2022,Unknown,Minnesota,,859,335,1194
7/24/2022,Wabasha,Minnesota,27157,6101,19,6120
7/24/2022,Wadena,Minnesota,27159,4512,58,4570
7/24/2022,Waseca,Minnesota,27161,5844,39,5883
7/24/2022,Washington,Minnesota,27163,74096,498,74594
7/24/2022,Watonwan,Minnesota,27165,3089,24,3113
7/24/2022,Wilkin,Minnesota,27167,1734,23,1757
7/24/2022,Winona,Minnesota,27169,14128,74,14202
7/24/2022,Wright,Minnesota,27171,38833,310,39143
7/24/2022,Yellow Medicine,Minnesota,27173,2712,31,2743
7/24/2022,Adams,Mississippi,28001,7761,145,7906
7/24/2022,Alcorn,Mississippi,28003,10688,161,10849
7/24/2022,Amite,Mississippi,28005,3434,69,3503
7/24/2022,Attala,Mississippi,28007,5733,114,5847
7/24/2022,Benton,Mississippi,28009,2386,49,2435
7/24/2022,Bolivar,Mississippi,28011,9923,180,10103
7/24/2022,Calhoun,Mississippi,28013,4801,71,4872
7/24/2022,Carroll,Mississippi,28015,2716,55,2771
7/24/2022,Chickasaw,Mississippi,28017,5878,97,5975
7/24/2022,Choctaw,Mississippi,28019,2488,33,2521
7/24/2022,Claiborne,Mississippi,28021,2268,46,2314
7/24/2022,Clarke,Mississippi,28023,4363,108,4471
7/24/2022,Clay,Mississippi,28025,5237,98,5335
7/24/2022,Coahoma,Mississippi,28027,6925,127,7052
7/24/2022,Copiah,Mississippi,28029,7888,121,8009
7/24/2022,Covington,Mississippi,28031,7502,114,7616
7/24/2022,DeSoto,Mississippi,28033,53805,556,54361
7/24/2022,Forrest,Mississippi,28035,23488,316,23804
7/24/2022,Franklin,Mississippi,28037,2022,38,2060
7/24/2022,George,Mississippi,28039,7574,88,7662
7/24/2022,Greene,Mississippi,28041,3396,59,3455
7/24/2022,Grenada,Mississippi,28043,5767,132,5899
7/24/2022,Hancock,Mississippi,28045,13078,153,13231
7/24/2022,Harrison,Mississippi,28047,57321,669,57990
7/24/2022,Hinds,Mississippi,28049,57355,799,58154
7/24/2022,Holmes,Mississippi,28051,4637,104,4741
7/24/2022,Humphreys,Mississippi,28053,2108,47,2155
7/24/2022,Issaquena,Mississippi,28055,280,9,289
7/24/2022,Itawamba,Mississippi,28057,7782,145,7927
7/24/2022,Jackson,Mississippi,28059,39544,469,40013
7/24/2022,Jasper,Mississippi,28061,5231,75,5306
7/24/2022,Jefferson,Mississippi,28063,1585,37,1622
7/24/2022,Jefferson Davis,Mississippi,28065,3031,55,3086
7/24/2022,Jones,Mississippi,28067,22315,297,22612
7/24/2022,Kemper,Mississippi,28069,2288,49,2337
7/24/2022,Lafayette,Mississippi,28071,16343,179,16522
7/24/2022,Lamar,Mississippi,28073,18600,160,18760
7/24/2022,Lauderdale,Mississippi,28075,19572,371,19943
7/24/2022,Lawrence,Mississippi,28077,3806,56,3862
7/24/2022,Leake,Mississippi,28079,6737,121,6858
7/24/2022,Lee,Mississippi,28081,28471,303,28774
7/24/2022,Leflore,Mississippi,28083,7783,171,7954
7/24/2022,Lincoln,Mississippi,28085,8854,158,9012
7/24/2022,Lowndes,Mississippi,28087,18495,241,18736
7/24/2022,Madison,Mississippi,28089,26545,334,26879
7/24/2022,Marion,Mississippi,28091,7368,136,7504
7/24/2022,Marshall,Mississippi,28093,10465,176,10641
7/24/2022,Monroe,Mississippi,28095,11480,223,11703
7/24/2022,Montgomery,Mississippi,28097,3120,79,3199
7/24/2022,Neshoba,Mississippi,28099,11028,241,11269
7/24/2022,Newton,Mississippi,28101,6303,98,6401
7/24/2022,Noxubee,Mississippi,28103,2881,48,2929
7/24/2022,Oktibbeha,Mississippi,28105,11707,165,11872
7/24/2022,Panola,Mississippi,28107,11084,170,11254
7/24/2022,Pearl River,Mississippi,28109,15942,278,16220
7/24/2022,Perry,Mississippi,28111,3212,64,3276
7/24/2022,Pike,Mississippi,28113,10359,189,10548
7/24/2022,Pontotoc,Mississippi,28115,10875,147,11022
7/24/2022,Prentiss,Mississippi,28117,8604,103,8707
7/24/2022,Quitman,Mississippi,28119,1661,31,1692
7/24/2022,Rankin,Mississippi,28121,39667,492,40159
7/24/2022,Scott,Mississippi,28123,6872,119,6991
7/24/2022,Sharkey,Mississippi,28125,1039,27,1066
7/24/2022,Simpson,Mississippi,28127,7466,150,7616
7/24/2022,Smith,Mississippi,28129,4352,69,4421
7/24/2022,Stone,Mississippi,28131,5689,72,5761
7/24/2022,Sunflower,Mississippi,28133,5979,126,6105
7/24/2022,Tallahatchie,Mississippi,28135,3345,60,3405
7/24/2022,Tate,Mississippi,28137,7862,145,8007
7/24/2022,Tippah,Mississippi,28139,7760,109,7869
7/24/2022,Tishomingo,Mississippi,28141,6489,122,6611
7/24/2022,Tunica,Mississippi,28143,2723,48,2771
7/24/2022,Union,Mississippi,28145,9969,123,10092
7/24/2022,Unknown,Mississippi,,17154,57,17211
7/24/2022,Walthall,Mississippi,28147,3837,80,3917
7/24/2022,Warren,Mississippi,28149,11018,204,11222
7/24/2022,Washington,Mississippi,28151,10979,200,11179
7/24/2022,Wayne,Mississippi,28153,6184,87,6271
7/24/2022,Webster,Mississippi,28155,3507,70,3577
7/24/2022,Wilkinson,Mississippi,28157,1848,46,1894
7/24/2022,Winston,Mississippi,28159,5573,104,5677
7/24/2022,Yalobusha,Mississippi,28161,4333,57,4390
7/24/2022,Yazoo,Mississippi,28163,8502,109,8611
7/24/2022,Adair,Missouri,29001,5904,68,5972
7/24/2022,Andrew,Missouri,29003,5068,59,5127
7/24/2022,Atchison,Missouri,29005,1492,23,1515
7/24/2022,Audrain,Missouri,29007,5991,114,6105
7/24/2022,Barry,Missouri,29009,7080,144,7224
7/24/2022,Barton,Missouri,29011,3021,52,3073
7/24/2022,Bates,Missouri,29013,3911,98,4009
7/24/2022,Benton,Missouri,29015,4630,108,4738
7/24/2022,Bollinger,Missouri,29017,2784,43,2827
7/24/2022,Boone,Missouri,29019,48769,263,49032
7/24/2022,Buchanan,Missouri,29021,26081,322,26403
7/24/2022,Butler,Missouri,29023,10761,176,10937
7/24/2022,Caldwell,Missouri,29025,1811,39,1850
7/24/2022,Callaway,Missouri,29027,12763,133,12896
7/24/2022,Camden,Missouri,29029,9889,183,10072
7/24/2022,Cape Girardeau,Missouri,29031,20278,247,20525
7/24/2022,Carroll,Missouri,29033,2307,45,2352
7/24/2022,Carter,Missouri,29035,1551,24,1575
7/24/2022,Cass,Missouri,29037,26956,322,27278
7/24/2022,Cedar,Missouri,29039,3164,57,3221
7/24/2022,Chariton,Missouri,29041,1798,38,1836
7/24/2022,Christian,Missouri,29043,22383,268,22651
7/24/2022,Clark,Missouri,29045,1699,40,1739
7/24/2022,Clay,Missouri,29047,29401,371,29772
7/24/2022,Clinton,Missouri,29049,5048,123,5171
7/24/2022,Cole,Missouri,29051,21292,291,21583
7/24/2022,Cooper,Missouri,29053,4279,79,4358
7/24/2022,Crawford,Missouri,29055,5734,107,5841
7/24/2022,Dade,Missouri,29057,1557,43,1600
7/24/2022,Dallas,Missouri,29059,4107,75,4182
7/24/2022,Daviess,Missouri,29061,1800,30,1830
7/24/2022,DeKalb,Missouri,29063,2314,47,2361
7/24/2022,Dent,Missouri,29065,3461,87,3548
7/24/2022,Douglas,Missouri,29067,2696,82,2778
7/24/2022,Dunklin,Missouri,29069,8437,129,8566
7/24/2022,Franklin,Missouri,29071,27713,380,28093
7/24/2022,Gasconade,Missouri,29073,3598,104,3702
7/24/2022,Gentry,Missouri,29075,2277,32,2309
7/24/2022,Greene,Missouri,29077,76359,1060,77419
7/24/2022,Grundy,Missouri,29079,2716,69,2785
7/24/2022,Harrison,Missouri,29081,2004,35,2039
7/24/2022,Henry,Missouri,29083,6150,89,6239
7/24/2022,Hickory,Missouri,29085,2007,56,2063
7/24/2022,Holt,Missouri,29087,1137,30,1167
7/24/2022,Howard,Missouri,29089,2610,30,2640
7/24/2022,Howell,Missouri,29091,9717,221,9938
7/24/2022,Iron,Missouri,29093,2323,45,2368
7/24/2022,Jackson,Missouri,29095,103963,1236,105199
7/24/2022,Jasper,Missouri,29097,22009,326,22335
7/24/2022,Jefferson,Missouri,29099,59205,666,59871
7/24/2022,Johnson,Missouri,29101,12897,145,13042
7/24/2022,Joplin,Missouri,,14661,221,14882
7/24/2022,Kansas City,Missouri,,124012,1334,125346
7/24/2022,Knox,Missouri,29103,1077,14,1091
7/24/2022,Laclede,Missouri,29105,8590,179,8769
7/24/2022,Lafayette,Missouri,29107,8286,137,8423
7/24/2022,Lawrence,Missouri,29109,8225,168,8393
7/24/2022,Lewis,Missouri,29111,2963,43,3006
7/24/2022,Lincoln,Missouri,29113,16267,142,16409
7/24/2022,Linn,Missouri,29115,2748,66,2814
7/24/2022,Livingston,Missouri,29117,3928,99,4027
7/24/2022,Macon,Missouri,29121,3862,60,3922
7/24/2022,Madison,Missouri,29123,3789,58,3847
7/24/2022,Maries,Missouri,29125,1717,39,1756
7/24/2022,Marion,Missouri,29127,8593,125,8718
7/24/2022,McDonald,Missouri,29119,6085,81,6166
7/24/2022,Mercer,Missouri,29129,781,14,795
7/24/2022,Miller,Missouri,29131,6381,124,6505
7/24/2022,Mississippi,Missouri,29133,3709,59,3768
7/24/2022,Moniteau,Missouri,29135,3950,57,4007
7/24/2022,Monroe,Missouri,29137,2255,45,2300
7/24/2022,Montgomery,Missouri,29139,2679,58,2737
7/24/2022,Morgan,Missouri,29141,4283,116,4399
7/24/2022,New Madrid,Missouri,29143,5279,86,5365
7/24/2022,Newton,Missouri,29145,12471,209,12680
7/24/2022,Nodaway,Missouri,29147,6405,46,6451
7/24/2022,Oregon,Missouri,29149,2126,37,2163
7/24/2022,Osage,Missouri,29151,3365,46,3411
7/24/2022,Ozark,Missouri,29153,1831,62,1893
7/24/2022,Pemiscot,Missouri,29155,3208,81,3289
7/24/2022,Perry,Missouri,29157,5457,46,5503
7/24/2022,Pettis,Missouri,29159,12982,173,13155
7/24/2022,Phelps,Missouri,29161,11093,248,11341
7/24/2022,Pike,Missouri,29163,4515,64,4579
7/24/2022,Platte,Missouri,29165,11373,102,11475
7/24/2022,Polk,Missouri,29167,8676,109,8785
7/24/2022,Pulaski,Missouri,29169,9732,117,9849
7/24/2022,Putnam,Missouri,29171,1089,25,1114
7/24/2022,Ralls,Missouri,29173,2619,28,2647
7/24/2022,Randolph,Missouri,29175,6342,106,6448
7/24/2022,Ray,Missouri,29177,5499,95,5594
7/24/2022,Reynolds,Missouri,29179,1223,26,1249
7/24/2022,Ripley,Missouri,29181,2830,61,2891
7/24/2022,Saline,Missouri,29195,6568,109,6677
7/24/2022,Schuyler,Missouri,29197,782,26,808
7/24/2022,Scotland,Missouri,29199,700,18,718
7/24/2022,Scott,Missouri,29201,11794,162,11956
7/24/2022,Shannon,Missouri,29203,1695,40,1735
7/24/2022,Shelby,Missouri,29205,1786,15,1801
7/24/2022,St. Charles,Missouri,29183,114013,957,114970
7/24/2022,St. Clair,Missouri,29185,2230,37,2267
7/24/2022,Ste. Genevieve,Missouri,29186,4031,39,4070
7/24/2022,St. Francois,Missouri,29187,20234,300,20534
7/24/2022,St. Louis,Missouri,29189,254594,3412,258006
7/24/2022,St. Louis city,Missouri,29510,65676,800,66476
7/24/2022,Stoddard,Missouri,29207,6392,139,6531
7/24/2022,Stone,Missouri,29209,6236,123,6359
7/24/2022,Sullivan,Missouri,29211,1797,23,1820
7/24/2022,Taney,Missouri,29213,14415,236,14651
7/24/2022,Texas,Missouri,29215,4951,107,5058
7/24/2022,Vernon,Missouri,29217,5436,111,5547
7/24/2022,Warren,Missouri,29219,8744,104,8848
7/24/2022,Washington,Missouri,29221,6341,143,6484
7/24/2022,Wayne,Missouri,29223,2522,54,2576
7/24/2022,Webster,Missouri,29225,9413,154,9567
7/24/2022,Worth,Missouri,29227,428,3,431
7/24/2022,Wright,Missouri,29229,4074,91,4165
7/24/2022,Beaverhead,Montana,30001,2278,30,2308
7/24/2022,Big Horn,Montana,30003,5124,100,5224
7/24/2022,Blaine,Montana,30005,2207,33,2240
7/24/2022,Broadwater,Montana,30007,1363,21,1384
7/24/2022,Carbon,Montana,30009,2205,28,2233
7/24/2022,Carter,Montana,30011,264,5,269
7/24/2022,Cascade,Montana,30013,26791,351,27142
7/24/2022,Chouteau,Montana,30015,1074,15,1089
7/24/2022,Custer,Montana,30017,3160,49,3209
7/24/2022,Daniels,Montana,30019,405,9,414
7/24/2022,Dawson,Montana,30021,2470,58,2528
7/24/2022,Deer Lodge,Montana,30023,2789,30,2819
7/24/2022,Fallon,Montana,30025,700,10,710
7/24/2022,Fergus,Montana,30027,2613,57,2670
7/24/2022,Flathead,Montana,30029,31051,290,31341
7/24/2022,Gallatin,Montana,30031,38090,124,38214
7/24/2022,Garfield,Montana,30033,243,3,246
7/24/2022,Glacier,Montana,30035,4210,75,4285
7/24/2022,Golden Valley,Montana,30037,154,5,159
7/24/2022,Granite,Montana,30039,589,10,599
7/24/2022,Hill,Montana,30041,4779,73,4852
7/24/2022,Jefferson,Montana,30043,2828,25,2853
7/24/2022,Judith Basin,Montana,30045,244,1,245
7/24/2022,Lake,Montana,30047,7254,102,7356
7/24/2022,Lewis and Clark,Montana,30049,19541,192,19733
7/24/2022,Liberty,Montana,30051,438,4,442
7/24/2022,Lincoln,Montana,30053,5089,90,5179
7/24/2022,Madison,Montana,30057,2045,23,2068
7/24/2022,McCone,Montana,30055,397,9,406
7/24/2022,Meagher,Montana,30059,481,10,491
7/24/2022,Mineral,Montana,30061,1210,17,1227
7/24/2022,Missoula,Montana,30063,30172,213,30385
7/24/2022,Musselshell,Montana,30065,957,31,988
7/24/2022,Park,Montana,30067,4709,35,4744
7/24/2022,Petroleum,Montana,30069,35,1,36
7/24/2022,Phillips,Montana,30071,1089,29,1118
7/24/2022,Pondera,Montana,30073,1291,9,1300
7/24/2022,Powder River,Montana,30075,375,10,385
7/24/2022,Powell,Montana,30077,1989,30,2019
7/24/2022,Prairie,Montana,30079,273,3,276
7/24/2022,Ravalli,Montana,30081,7536,165,7701
7/24/2022,Richland,Montana,30083,2740,36,2776
7/24/2022,Roosevelt,Montana,30085,3386,75,3461
7/24/2022,Rosebud,Montana,30087,2739,61,2800
7/24/2022,Sanders,Montana,30089,2253,52,2305
7/24/2022,Sheridan,Montana,30091,772,12,784
7/24/2022,Silver Bow,Montana,30093,9041,134,9175
7/24/2022,Stillwater,Montana,30095,1596,32,1628
7/24/2022,Sweet Grass,Montana,30097,824,13,837
7/24/2022,Teton,Montana,30099,1388,25,1413
7/24/2022,Toole,Montana,30101,1304,25,1329
7/24/2022,Treasure,Montana,30103,139,1,140
7/24/2022,Valley,Montana,30105,1858,38,1896
7/24/2022,Wheatland,Montana,30107,406,14,420
7/24/2022,Wibaux,Montana,30109,207,8,215
7/24/2022,Yellowstone,Montana,30111,45471,566,46037
7/24/2022,Adams,Nebraska,31001,6909,73,6982
7/24/2022,Antelope,Nebraska,31003,1144,14,1158
7/24/2022,Arthur,Nebraska,31005,33,1,34
7/24/2022,Banner,Nebraska,31007,92,2,94
7/24/2022,Blaine,Nebraska,31009,70,3,73
7/24/2022,Boone,Nebraska,31011,1117,5,1122
7/24/2022,Box Butte,Nebraska,31013,2320,17,2337
7/24/2022,Boyd,Nebraska,31015,423,7,430
7/24/2022,Brown,Nebraska,31017,573,4,577
7/24/2022,Buffalo,Nebraska,31019,12714,104,12818
7/24/2022,Burt,Nebraska,31021,1364,17,1381
7/24/2022,Butler,Nebraska,31023,2020,18,2038
7/24/2022,Cass,Nebraska,31025,6491,46,6537
7/24/2022,Cedar,Nebraska,31027,1545,14,1559
7/24/2022,Chase,Nebraska,31029,831,7,838
7/24/2022,Cherry,Nebraska,31031,573,12,585
7/24/2022,Cheyenne,Nebraska,31033,2129,24,2153
7/24/2022,Clay,Nebraska,31035,1577,25,1602
7/24/2022,Colfax,Nebraska,31037,2745,28,2773
7/24/2022,Cuming,Nebraska,31039,1880,15,1895
7/24/2022,Custer,Nebraska,31041,2122,31,2153
7/24/2022,Dakota,Nebraska,31043,7105,82,7187
7/24/2022,Dawes,Nebraska,31045,1423,21,1444
7/24/2022,Dawson,Nebraska,31047,5473,44,5517
7/24/2022,Deuel,Nebraska,31049,328,3,331
7/24/2022,Dixon,Nebraska,31051,1253,11,1264
7/24/2022,Dodge,Nebraska,31053,10572,111,10683
7/24/2022,Douglas,Nebraska,31055,161693,1140,162833
7/24/2022,Dundy,Nebraska,31057,344,6,350
7/24/2022,Fillmore,Nebraska,31059,1191,13,1204
7/24/2022,Franklin,Nebraska,31061,432,13,445
7/24/2022,Frontier,Nebraska,31063,562,3,565
7/24/2022,Furnas,Nebraska,31065,1177,8,1185
7/24/2022,Gage,Nebraska,31067,3684,45,3729
7/24/2022,Garden,Nebraska,31069,399,1,400
7/24/2022,Garfield,Nebraska,31071,415,2,417
7/24/2022,Gosper,Nebraska,31073,406,7,413
7/24/2022,Grant,Nebraska,31075,101,6,107
7/24/2022,Greeley,Nebraska,31077,433,2,435
7/24/2022,Hall,Nebraska,31079,17244,146,17390
7/24/2022,Hamilton,Nebraska,31081,2446,26,2472
7/24/2022,Harlan,Nebraska,31083,363,3,366
7/24/2022,Hayes,Nebraska,31085,99,0,99
7/24/2022,Hitchcock,Nebraska,31087,563,8,571
7/24/2022,Holt,Nebraska,31089,2284,20,2304
7/24/2022,Hooker,Nebraska,31091,117,5,122
7/24/2022,Howard,Nebraska,31093,1228,16,1244
7/24/2022,Jefferson,Nebraska,31095,1258,7,1265
7/24/2022,Johnson,Nebraska,31097,886,10,896
7/24/2022,Kearney,Nebraska,31099,1270,9,1279
7/24/2022,Keith,Nebraska,31101,1628,20,1648
7/24/2022,Keya Paha,Nebraska,31103,123,0,123
7/24/2022,Kimball,Nebraska,31105,775,9,784
7/24/2022,Knox,Nebraska,31107,1727,13,1740
7/24/2022,Lancaster,Nebraska,31109,84349,445,84794
7/24/2022,Lincoln,Nebraska,31111,9354,120,9474
7/24/2022,Logan,Nebraska,31113,150,0,150
7/24/2022,Loup,Nebraska,31115,83,0,83
7/24/2022,Madison,Nebraska,31119,10058,70,10128
7/24/2022,McPherson,Nebraska,31117,71,1,72
7/24/2022,Merrick,Nebraska,31121,1802,17,1819
7/24/2022,Morrill,Nebraska,31123,1194,21,1215
7/24/2022,Nance,Nebraska,31125,804,13,817
7/24/2022,Nemaha,Nebraska,31127,1413,20,1433
7/24/2022,Nuckolls,Nebraska,31129,1009,13,1022
7/24/2022,Otoe,Nebraska,31131,3556,20,3576
7/24/2022,Pawnee,Nebraska,31133,461,4,465
7/24/2022,Perkins,Nebraska,31135,542,12,554
7/24/2022,Phelps,Nebraska,31137,2455,14,2469
7/24/2022,Pierce,Nebraska,31139,1308,21,1329
7/24/2022,Platte,Nebraska,31141,8975,75,9050
7/24/2022,Polk,Nebraska,31143,1230,18,1248
7/24/2022,Red Willow,Nebraska,31145,2434,20,2454
7/24/2022,Richardson,Nebraska,31147,1917,24,1941
7/24/2022,Rock,Nebraska,31149,182,2,184
7/24/2022,Saline,Nebraska,31151,3928,12,3940
7/24/2022,Sarpy,Nebraska,31153,53059,290,53349
7/24/2022,Saunders,Nebraska,31155,5194,30,5224
7/24/2022,Scotts Bluff,Nebraska,31157,9916,102,10018
7/24/2022,Seward,Nebraska,31159,3488,43,3531
7/24/2022,Sheridan,Nebraska,31161,1011,23,1034
7/24/2022,Sherman,Nebraska,31163,619,4,623
7/24/2022,Sioux,Nebraska,31165,76,1,77
7/24/2022,Stanton,Nebraska,31167,671,11,682
7/24/2022,Thayer,Nebraska,31169,1166,8,1174
7/24/2022,Thomas,Nebraska,31171,104,1,105
7/24/2022,Thurston,Nebraska,31173,1797,23,1820
7/24/2022,Unknown,Nebraska,,7107,512,7619
7/24/2022,Valley,Nebraska,31175,778,6,784
7/24/2022,Washington,Nebraska,31177,4850,45,4895
7/24/2022,Wayne,Nebraska,31179,1921,11,1932
7/24/2022,Webster,Nebraska,31181,738,11,749
7/24/2022,Wheeler,Nebraska,31183,124,2,126
7/24/2022,York,Nebraska,31185,4170,21,4191
7/24/2022,Carson City,Nevada,32510,16083,224,16307
7/24/2022,Churchill,Nevada,32001,7027,116,7143
7/24/2022,Clark,Nevada,32003,599109,8730,607839
7/24/2022,Douglas,Nevada,32005,8113,93,8206
7/24/2022,Elko,Nevada,32007,12210,139,12349
7/24/2022,Esmeralda,Nevada,32009,113,3,116
7/24/2022,Eureka,Nevada,32011,172,2,174
7/24/2022,Humboldt,Nevada,32013,2651,58,2709
7/24/2022,Lander,Nevada,32015,1231,21,1252
7/24/2022,Lincoln,Nevada,32017,556,8,564
7/24/2022,Lyon,Nevada,32019,11138,179,11317
7/24/2022,Mineral,Nevada,32021,1372,18,1390
7/24/2022,Nye,Nevada,32023,8211,277,8488
7/24/2022,Pershing,Nevada,32027,2249,31,2280
7/24/2022,Storey,Nevada,32029,161,13,174
7/24/2022,Unknown,Nevada,,8466,11,8477
7/24/2022,Washoe,Nevada,32031,117570,1255,118825
7/24/2022,White Pine,Nevada,32033,1708,22,1730
7/24/2022,Belknap,New Hampshire,33001,15234,187,15421
7/24/2022,Carroll,New Hampshire,33003,10735,65,10800
7/24/2022,Cheshire,New Hampshire,33005,16861,118,16979
7/24/2022,Coos,New Hampshire,33007,7605,120,7725
7/24/2022,Grafton,New Hampshire,33009,20836,76,20912
7/24/2022,Hillsborough,New Hampshire,33011,108028,940,108968
7/24/2022,Merrimack,New Hampshire,33013,35438,244,35682
7/24/2022,Rockingham,New Hampshire,33015,75446,571,76017
7/24/2022,Strafford,New Hampshire,33017,33118,220,33338
7/24/2022,Sullivan,New Hampshire,33019,10368,71,10439
7/24/2022,Unknown,New Hampshire,,2776,6,2782
7/24/2022,Atlantic,New Jersey,34001,77844,1024,78868
7/24/2022,Bergen,New Jersey,34003,270098,3523,273621
7/24/2022,Burlington,New Jersey,34005,119115,1265,120380
7/24/2022,Camden,New Jersey,34007,143335,1862,145197
7/24/2022,Cape May,New Jersey,34009,25487,313,25800
7/24/2022,Cumberland,New Jersey,34011,43933,621,44554
7/24/2022,Essex,New Jersey,34013,246653,3645,250298
7/24/2022,Gloucester,New Jersey,34015,78638,989,79627
7/24/2022,Hudson,New Jersey,34017,200845,2750,203595
7/24/2022,Hunterdon,New Jersey,34019,29006,281,29287
7/24/2022,Mercer,New Jersey,34021,91741,1287,93028
7/24/2022,Middlesex,New Jersey,34023,230398,2905,233303
7/24/2022,Monmouth,New Jersey,34025,190499,2249,192748
7/24/2022,Morris,New Jersey,34027,141385,1585,142970
7/24/2022,Ocean,New Jersey,34029,183359,3055,186414
7/24/2022,Passaic,New Jersey,34031,163833,2367,166200
7/24/2022,Salem,New Jersey,34033,15794,252,16046
7/24/2022,Somerset,New Jersey,34035,81902,986,82888
7/24/2022,Sussex,New Jersey,34037,38650,505,39155
7/24/2022,Union,New Jersey,34039,166497,2407,168904
7/24/2022,Unknown,New Jersey,,3092,0,3092
7/24/2022,Warren,New Jersey,34041,27098,346,27444
7/24/2022,Bernalillo,New Mexico,35001,170066,1996,172062
7/24/2022,Catron,New Mexico,35003,448,21,469
7/24/2022,Chaves,New Mexico,35005,22873,348,23221
7/24/2022,Cibola,New Mexico,35006,8944,200,9144
7/24/2022,Colfax,New Mexico,35007,2828,68,2896
7/24/2022,Curry,New Mexico,35009,13697,219,13916
7/24/2022,De Baca,New Mexico,35011,629,6,635
7/24/2022,Do�a Ana,New Mexico,35013,69083,842,69925
7/24/2022,Eddy,New Mexico,35015,17804,302,18106
7/24/2022,Grant,New Mexico,35017,8024,102,8126
7/24/2022,Guadalupe,New Mexico,35019,1551,17,1568
7/24/2022,Harding,New Mexico,35021,90,4,94
7/24/2022,Hidalgo,New Mexico,35023,1174,16,1190
7/24/2022,Lea,New Mexico,35025,21167,380,21547
7/24/2022,Lincoln,New Mexico,35027,5831,68,5899
7/24/2022,Los Alamos,New Mexico,35028,3900,18,3918
7/24/2022,Luna,New Mexico,35029,7283,139,7422
7/24/2022,McKinley,New Mexico,35031,28420,608,29028
7/24/2022,Mora,New Mexico,35033,888,20,908
7/24/2022,Otero,New Mexico,35035,16668,199,16867
7/24/2022,Quay,New Mexico,35037,2195,64,2259
7/24/2022,Rio Arriba,New Mexico,35039,11414,145,11559
7/24/2022,Roosevelt,New Mexico,35041,5343,106,5449
7/24/2022,Sandoval,New Mexico,35043,38824,467,39291
7/24/2022,San Juan,New Mexico,35045,45027,808,45835
7/24/2022,San Miguel,New Mexico,35047,6708,69,6777
7/24/2022,Santa Fe,New Mexico,35049,34865,327,35192
7/24/2022,Sierra,New Mexico,35051,2272,82,2354
7/24/2022,Socorro,New Mexico,35053,4181,92,4273
7/24/2022,Taos,New Mexico,35055,6260,96,6356
7/24/2022,Torrance,New Mexico,35057,3391,58,3449
7/24/2022,Union,New Mexico,35059,1053,17,1070
7/24/2022,Unknown,New Mexico,,222,0,222
7/24/2022,Valencia,New Mexico,35061,21281,289,21570
7/24/2022,Albany,New York,36001,68892,544,69436
7/24/2022,Allegany,New York,36003,9712,159,9871
7/24/2022,Broome,New York,36007,51602,535,52137
7/24/2022,Cattaraugus,New York,36009,17058,226,17284
7/24/2022,Cayuga,New York,36011,18032,162,18194
7/24/2022,Chautauqua,New York,36013,26195,307,26502
7/24/2022,Chemung,New York,36015,23658,240,23898
7/24/2022,Chenango,New York,36017,10382,124,10506
7/24/2022,Clinton,New York,36019,19516,95,19611
7/24/2022,Columbia,New York,36021,11797,150,11947
7/24/2022,Cortland,New York,36023,11795,125,11920
7/24/2022,Delaware,New York,36025,8911,80,8991
7/24/2022,Dutchess,New York,36027,72918,674,73592
7/24/2022,Erie,New York,36029,240844,2707,243551
7/24/2022,Essex,New York,36031,6682,65,6747
7/24/2022,Franklin,New York,36033,10630,48,10678
7/24/2022,Fulton,New York,36035,14268,173,14441
7/24/2022,Genesee,New York,36037,14996,195,15191
7/24/2022,Greene,New York,36039,9676,135,9811
7/24/2022,Hamilton,New York,36041,970,5,975
7/24/2022,Herkimer,New York,36043,15521,197,15718
7/24/2022,Jefferson,New York,36045,22863,142,23005
7/24/2022,Lewis,New York,36049,6636,51,6687
7/24/2022,Livingston,New York,36051,12913,121,13034
7/24/2022,Madison,New York,36053,14919,129,15048
7/24/2022,Monroe,New York,36055,172331,1661,173992
7/24/2022,Montgomery,New York,36057,13250,209,13459
7/24/2022,Nassau,New York,36059,470164,3946,474110
7/24/2022,New York City,New York,,2689907,40978,2730885
7/24/2022,Niagara,New York,36063,53875,598,54473
7/24/2022,Oneida,New York,36065,61116,821,61937
7/24/2022,Onondaga,New York,36067,127078,1099,128177
7/24/2022,Ontario,New York,36069,22858,190,23048
7/24/2022,Orange,New York,36071,119882,980,120862
7/24/2022,Orleans,New York,36073,9513,120,9633
7/24/2022,Oswego,New York,36075,29983,201,30184
7/24/2022,Otsego,New York,36077,11576,95,11671
7/24/2022,Putnam,New York,36079,27151,126,27277
7/24/2022,Rensselaer,New York,36083,36725,277,37002
7/24/2022,Rockland,New York,36087,103455,913,104368
7/24/2022,Saratoga,New York,36091,54022,350,54372
7/24/2022,Schenectady,New York,36093,38426,320,38746
7/24/2022,Schoharie,New York,36095,5704,36,5740
7/24/2022,Schuyler,New York,36097,3925,28,3953
7/24/2022,Seneca,New York,36099,6693,94,6787
7/24/2022,Steuben,New York,36101,22436,258,22694
7/24/2022,St. Lawrence,New York,36089,23465,198,23663
7/24/2022,Suffolk,New York,36103,485425,4504,489929
7/24/2022,Sullivan,New York,36105,20819,133,20952
7/24/2022,Tioga,New York,36107,12311,86,12397
7/24/2022,Tompkins,New York,36109,23125,89,23214
7/24/2022,Ulster,New York,36111,36776,379,37155
7/24/2022,Warren,New York,36113,16176,131,16307
7/24/2022,Washington,New York,36115,13771,121,13892
7/24/2022,Wayne,New York,36117,19378,186,19564
7/24/2022,Westchester,New York,36119,290472,2767,293239
7/24/2022,Wyoming,New York,36121,9057,85,9142
7/24/2022,Yates,New York,36123,3892,40,3932
7/24/2022,Alamance,North Carolina,37001,52044,509,52553
7/24/2022,Alexander,North Carolina,37003,10925,144,11069
7/24/2022,Alleghany,North Carolina,37005,3115,17,3132
7/24/2022,Anson,North Carolina,37007,7087,101,7188
7/24/2022,Ashe,North Carolina,37009,6628,84,6712
7/24/2022,Avery,North Carolina,37011,4886,46,4932
7/24/2022,Beaufort,North Carolina,37013,13722,178,13900
7/24/2022,Bertie,North Carolina,37015,4602,71,4673
7/24/2022,Bladen,North Carolina,37017,10158,133,10291
7/24/2022,Brunswick,North Carolina,37019,34231,340,34571
7/24/2022,Buncombe,North Carolina,37021,60425,618,61043
7/24/2022,Burke,North Carolina,37023,26893,334,27227
7/24/2022,Cabarrus,North Carolina,37025,61784,510,62294
7/24/2022,Caldwell,North Carolina,37027,24018,312,24330
7/24/2022,Camden,North Carolina,37029,1917,9,1926
7/24/2022,Carteret,North Carolina,37031,15877,134,16011
7/24/2022,Caswell,North Carolina,37033,5814,53,5867
7/24/2022,Catawba,North Carolina,37035,51433,616,52049
7/24/2022,Chatham,North Carolina,37037,14897,121,15018
7/24/2022,Cherokee,North Carolina,37039,7548,125,7673
7/24/2022,Chowan,North Carolina,37041,4486,62,4548
7/24/2022,Clay,North Carolina,37043,2830,47,2877
7/24/2022,Cleveland,North Carolina,37045,31678,405,32083
7/24/2022,Columbus,North Carolina,37047,16763,273,17036
7/24/2022,Craven,North Carolina,37049,27318,214,27532
7/24/2022,Cumberland,North Carolina,37051,97088,669,97757
7/24/2022,Currituck,North Carolina,37053,5478,37,5515
7/24/2022,Dare,North Carolina,37055,8575,27,8602
7/24/2022,Davidson,North Carolina,37057,46830,440,47270
7/24/2022,Davie,North Carolina,37059,12403,110,12513
7/24/2022,Duplin,North Carolina,37061,17764,250,18014
7/24/2022,Durham,North Carolina,37063,87216,345,87561
7/24/2022,Edgecombe,North Carolina,37065,14773,155,14928
7/24/2022,Forsyth,North Carolina,37067,103725,850,104575
7/24/2022,Franklin,North Carolina,37069,22885,82,22967
7/24/2022,Gaston,North Carolina,37071,70771,871,71642
7/24/2022,Gates,North Carolina,37073,2073,20,2093
7/24/2022,Graham,North Carolina,37075,2439,31,2470
7/24/2022,Granville,North Carolina,37077,16240,118,16358
7/24/2022,Greene,North Carolina,37079,6237,71,6308
7/24/2022,Guilford,North Carolina,37081,133694,1255,134949
7/24/2022,Halifax,North Carolina,37083,15358,190,15548
7/24/2022,Harnett,North Carolina,37085,36575,347,36922
7/24/2022,Haywood,North Carolina,37087,14401,227,14628
7/24/2022,Henderson,North Carolina,37089,27448,327,27775
7/24/2022,Hertford,North Carolina,37091,5227,90,5317
7/24/2022,Hoke,North Carolina,37093,16509,121,16630
7/24/2022,Hyde,North Carolina,37095,1485,14,1499
7/24/2022,Iredell,North Carolina,37097,52727,484,53211
7/24/2022,Jackson,North Carolina,37099,10488,99,10587
7/24/2022,Johnston,North Carolina,37101,65413,463,65876
7/24/2022,Jones,North Carolina,37103,2450,39,2489
7/24/2022,Lee,North Carolina,37105,17322,152,17474
7/24/2022,Lenoir,North Carolina,37107,16945,235,17180
7/24/2022,Lincoln,North Carolina,37109,26211,184,26395
7/24/2022,Macon,North Carolina,37113,8544,123,8667
7/24/2022,Madison,North Carolina,37115,5604,81,5685
7/24/2022,Martin,North Carolina,37117,6641,95,6736
7/24/2022,McDowell,North Carolina,37111,14914,176,15090
7/24/2022,Mecklenburg,North Carolina,37119,314261,1671,315932
7/24/2022,Mitchell,North Carolina,37121,3922,40,3962
7/24/2022,Montgomery,North Carolina,37123,7688,133,7821
7/24/2022,Moore,North Carolina,37125,26722,333,27055
7/24/2022,Nash,North Carolina,37127,28368,324,28692
7/24/2022,New Hanover,North Carolina,37129,56114,406,56520
7/24/2022,Northampton,North Carolina,37131,4829,87,4916
7/24/2022,Onslow,North Carolina,37133,56653,387,57040
7/24/2022,Orange,North Carolina,37135,32773,139,32912
7/24/2022,Pamlico,North Carolina,37137,2933,29,2962
7/24/2022,Pasquotank,North Carolina,37139,9169,129,9298
7/24/2022,Pender,North Carolina,37141,16435,133,16568
7/24/2022,Perquimans,North Carolina,37143,2981,25,3006
7/24/2022,Person,North Carolina,37145,10432,111,10543
7/24/2022,Pitt,North Carolina,37147,57558,252,57810
7/24/2022,Polk,North Carolina,37149,4228,65,4293
7/24/2022,Randolph,North Carolina,37151,38087,458,38545
7/24/2022,Richmond,North Carolina,37153,14026,195,14221
7/24/2022,Robeson,North Carolina,37155,44404,553,44957
7/24/2022,Rockingham,North Carolina,37157,23718,302,24020
7/24/2022,Rowan,North Carolina,37159,44398,598,44996
7/24/2022,Rutherford,North Carolina,37161,18705,408,19113
7/24/2022,Sampson,North Carolina,37163,20045,188,20233
7/24/2022,Scotland,North Carolina,37165,10987,135,11122
7/24/2022,Stanly,North Carolina,37167,20617,265,20882
7/24/2022,Stokes,North Carolina,37169,12277,185,12462
7/24/2022,Surry,North Carolina,37171,23025,362,23387
7/24/2022,Swain,North Carolina,37173,4042,47,4089
7/24/2022,Transylvania,North Carolina,37175,6791,78,6869
7/24/2022,Tyrrell,North Carolina,37177,1056,9,1065
7/24/2022,Union,North Carolina,37179,68026,500,68526
7/24/2022,Vance,North Carolina,37181,13164,126,13290
7/24/2022,Wake,North Carolina,37183,342005,1172,343177
7/24/2022,Warren,North Carolina,37185,4838,47,4885
7/24/2022,Washington,North Carolina,37187,3286,51,3337
7/24/2022,Watauga,North Carolina,37189,12913,70,12983
7/24/2022,Wayne,North Carolina,37191,34245,414,34659
7/24/2022,Wilkes,North Carolina,37193,19026,276,19302
7/24/2022,Wilson,North Carolina,37195,23536,328,23864
7/24/2022,Yadkin,North Carolina,37197,12119,121,12240
7/24/2022,Yancey,North Carolina,37199,5688,59,5747
7/24/2022,Adams,North Dakota,38001,624,10,634
7/24/2022,Barnes,North Dakota,38003,3138,47,3185
7/24/2022,Benson,North Dakota,38005,2067,23,2090
7/24/2022,Billings,North Dakota,38007,158,1,159
7/24/2022,Bottineau,North Dakota,38009,1695,26,1721
7/24/2022,Bowman,North Dakota,38011,871,9,880
7/24/2022,Burke,North Dakota,38013,453,3,456
7/24/2022,Burleigh,North Dakota,38015,37004,303,37307
7/24/2022,Cass,North Dakota,38017,63476,333,63809
7/24/2022,Cavalier,North Dakota,38019,883,7,890
7/24/2022,Dickey,North Dakota,38021,1561,39,1600
7/24/2022,Divide,North Dakota,38023,506,4,510
7/24/2022,Dunn,North Dakota,38025,1096,8,1104
7/24/2022,Eddy,North Dakota,38027,797,6,803
7/24/2022,Emmons,North Dakota,38029,754,18,772
7/24/2022,Foster,North Dakota,38031,1033,23,1056
7/24/2022,Golden Valley,North Dakota,38033,486,4,490
7/24/2022,Grand Forks,North Dakota,38035,23706,125,23831
7/24/2022,Grant,North Dakota,38037,482,11,493
7/24/2022,Griggs,North Dakota,38039,616,2,618
7/24/2022,Hettinger,North Dakota,38041,848,8,856
7/24/2022,Kidder,North Dakota,38043,538,13,551
7/24/2022,LaMoure,North Dakota,38045,1054,20,1074
7/24/2022,Logan,North Dakota,38047,456,12,468
7/24/2022,McHenry,North Dakota,38049,1405,31,1436
7/24/2022,McIntosh,North Dakota,38051,721,9,730
7/24/2022,McKenzie,North Dakota,38053,3390,25,3415
7/24/2022,McLean,North Dakota,38055,2861,49,2910
7/24/2022,Mercer,North Dakota,38057,2716,24,2740
7/24/2022,Morton,North Dakota,38059,11865,142,12007
7/24/2022,Mountrail,North Dakota,38061,3440,37,3477
7/24/2022,Nelson,North Dakota,38063,804,18,822
7/24/2022,Oliver,North Dakota,38065,338,5,343
7/24/2022,Pembina,North Dakota,38067,2122,16,2138
7/24/2022,Pierce,North Dakota,38069,1112,32,1144
7/24/2022,Ramsey,North Dakota,38071,3798,57,3855
7/24/2022,Ransom,North Dakota,38073,1598,28,1626
7/24/2022,Renville,North Dakota,38075,576,15,591
7/24/2022,Richland,North Dakota,38077,4272,23,4295
7/24/2022,Rolette,North Dakota,38079,6778,43,6821
7/24/2022,Sargent,North Dakota,38081,1092,9,1101
7/24/2022,Sheridan,North Dakota,38083,311,7,318
7/24/2022,Sioux,North Dakota,38085,1429,19,1448
7/24/2022,Slope,North Dakota,38087,66,0,66
7/24/2022,Stark,North Dakota,38089,12217,86,12303
7/24/2022,Steele,North Dakota,38091,394,2,396
7/24/2022,Stutsman,North Dakota,38093,7453,97,7550
7/24/2022,Towner,North Dakota,38095,676,12,688
7/24/2022,Traill,North Dakota,38097,2263,26,2289
7/24/2022,Unknown,North Dakota,,0,119,119
7/24/2022,Walsh,North Dakota,38099,3592,34,3626
7/24/2022,Ward,North Dakota,38101,21853,251,22104
7/24/2022,Wells,North Dakota,38103,1073,12,1085
7/24/2022,Williams,North Dakota,38105,10959,68,11027
7/24/2022,Rota,Northern Mariana Islands,69100,418,0,418
7/24/2022,Saipan,Northern Mariana Islands,69110,11985,35,12020
7/24/2022,Tinian,Northern Mariana Islands,69120,360,0,360
7/24/2022,Adams,Ohio,39001,7544,152,7696
7/24/2022,Allen,Ohio,39003,29032,481,29513
7/24/2022,Ashland,Ohio,39005,12740,220,12960
7/24/2022,Ashtabula,Ohio,39007,21827,435,22262
7/24/2022,Athens,Ohio,39009,16390,145,16535
7/24/2022,Auglaize,Ohio,39011,12180,190,12370
7/24/2022,Belmont,Ohio,39013,16780,315,17095
7/24/2022,Brown,Ohio,39015,11912,184,12096
7/24/2022,Butler,Ohio,39017,100235,1171,101406
7/24/2022,Carroll,Ohio,39019,5579,129,5708
7/24/2022,Champaign,Ohio,39021,9336,149,9485
7/24/2022,Clark,Ohio,39023,37434,592,38026
7/24/2022,Clermont,Ohio,39025,55982,563,56545
7/24/2022,Clinton,Ohio,39027,11020,171,11191
7/24/2022,Columbiana,Ohio,39029,25961,488,26449
7/24/2022,Coshocton,Ohio,39031,8481,161,8642
7/24/2022,Crawford,Ohio,39033,12003,217,12220
7/24/2022,Cuyahoga,Ohio,39035,297673,3854,301527
7/24/2022,Darke,Ohio,39037,13087,242,13329
7/24/2022,Defiance,Ohio,39039,10699,167,10866
7/24/2022,Delaware,Ohio,39041,49462,274,49736
7/24/2022,Erie,Ohio,39043,21194,268,21462
7/24/2022,Fairfield,Ohio,39045,41496,436,41932
7/24/2022,Fayette,Ohio,39047,8261,122,8383
7/24/2022,Franklin,Ohio,39049,320084,2642,322726
7/24/2022,Fulton,Ohio,39051,10956,180,11136
7/24/2022,Gallia,Ohio,39053,8424,129,8553
7/24/2022,Geauga,Ohio,39055,17466,270,17736
7/24/2022,Greene,Ohio,39057,41306,518,41824
7/24/2022,Guernsey,Ohio,39059,11336,156,11492
7/24/2022,Hamilton,Ohio,39061,206549,2087,208636
7/24/2022,Hancock,Ohio,39063,18203,278,18481
7/24/2022,Hardin,Ohio,39065,7473,161,7634
7/24/2022,Harrison,Ohio,39067,3480,73,3553
7/24/2022,Henry,Ohio,39069,6799,108,6907
7/24/2022,Highland,Ohio,39071,11368,185,11553
7/24/2022,Hocking,Ohio,39073,7157,125,7282
7/24/2022,Holmes,Ohio,39075,5282,184,5466
7/24/2022,Huron,Ohio,39077,15430,224,15654
7/24/2022,Jackson,Ohio,39079,9747,141,9888
7/24/2022,Jefferson,Ohio,39081,16004,326,16330
7/24/2022,Knox,Ohio,39083,14283,230,14513
7/24/2022,Lake,Ohio,39085,53144,745,53889
7/24/2022,Lawrence,Ohio,39087,19744,260,20004
7/24/2022,Licking,Ohio,39089,45253,481,45734
7/24/2022,Logan,Ohio,39091,10921,174,11095
7/24/2022,Lorain,Ohio,39093,74280,994,75274
7/24/2022,Lucas,Ohio,39095,109954,1433,111387
7/24/2022,Madison,Ohio,39097,10253,139,10392
7/24/2022,Mahoning,Ohio,39099,57687,1101,58788
7/24/2022,Marion,Ohio,39101,21300,272,21572
7/24/2022,Medina,Ohio,39103,43839,516,44355
7/24/2022,Meigs,Ohio,39105,5090,91,5181
7/24/2022,Mercer,Ohio,39107,10000,144,10144
7/24/2022,Miami,Ohio,39109,27560,486,28046
7/24/2022,Monroe,Ohio,39111,3707,81,3788
7/24/2022,Montgomery,Ohio,39113,138214,2036,140250
7/24/2022,Morgan,Ohio,39115,3562,61,3623
7/24/2022,Morrow,Ohio,39117,8274,105,8379
7/24/2022,Muskingum,Ohio,39119,27221,295,27516
7/24/2022,Noble,Ohio,39121,3437,59,3496
7/24/2022,Ottawa,Ohio,39123,9230,141,9371
7/24/2022,Paulding,Ohio,39125,4874,74,4948
7/24/2022,Perry,Ohio,39127,8895,128,9023
7/24/2022,Pickaway,Ohio,39129,18617,231,18848
7/24/2022,Pike,Ohio,39131,8108,123,8231
7/24/2022,Portage,Ohio,39133,37566,450,38016
7/24/2022,Preble,Ohio,39135,10054,200,10254
7/24/2022,Putnam,Ohio,39137,8774,159,8933
7/24/2022,Richland,Ohio,39139,33704,516,34220
7/24/2022,Ross,Ohio,39141,20885,305,21190
7/24/2022,Sandusky,Ohio,39143,14819,240,15059
7/24/2022,Scioto,Ohio,39145,22748,261,23009
7/24/2022,Seneca,Ohio,39147,13447,234,13681
7/24/2022,Shelby,Ohio,39149,11667,189,11856
7/24/2022,Stark,Ohio,39151,85624,1729,87353
7/24/2022,Summit,Ohio,39153,123691,1735,125426
7/24/2022,Trumbull,Ohio,39155,45008,950,45958
7/24/2022,Tuscarawas,Ohio,39157,21879,508,22387
7/24/2022,Union,Ohio,39159,17164,102,17266
7/24/2022,Unknown,Ohio,,0,5,5
7/24/2022,Van Wert,Ohio,39161,7083,149,7232
7/24/2022,Vinton,Ohio,39163,3110,56,3166
7/24/2022,Warren,Ohio,39165,63072,592,63664
7/24/2022,Washington,Ohio,39167,13233,210,13443
7/24/2022,Wayne,Ohio,39169,24772,444,25216
7/24/2022,Williams,Ohio,39171,9597,164,9761
7/24/2022,Wood,Ohio,39173,33999,365,34364
7/24/2022,Wyandot,Ohio,39175,5651,105,5756
7/24/2022,Adair,Oklahoma,40001,8463,77,8540
7/24/2022,Alfalfa,Oklahoma,40003,1733,16,1749
7/24/2022,Atoka,Oklahoma,40005,4077,54,4131
7/24/2022,Beaver,Oklahoma,40007,1025,11,1036
7/24/2022,Beckham,Oklahoma,40009,6194,107,6301
7/24/2022,Blaine,Oklahoma,40011,2549,44,2593
7/24/2022,Bryan,Oklahoma,40013,14446,137,14583
7/24/2022,Caddo,Oklahoma,40015,8711,172,8883
7/24/2022,Canadian,Oklahoma,40017,42122,394,42516
7/24/2022,Carter,Oklahoma,40019,15271,242,15513
7/24/2022,Cherokee,Oklahoma,40021,15347,155,15502
7/24/2022,Choctaw,Oklahoma,40023,4266,64,4330
7/24/2022,Cimarron,Oklahoma,40025,604,7,611
7/24/2022,Cleveland,Oklahoma,40027,84946,831,85777
7/24/2022,Coal,Oklahoma,40029,1764,24,1788
7/24/2022,Comanche,Oklahoma,40031,34560,402,34962
7/24/2022,Cotton,Oklahoma,40033,1509,32,1541
7/24/2022,Craig,Oklahoma,40035,5058,55,5113
7/24/2022,Creek,Oklahoma,40037,19199,339,19538
7/24/2022,Custer,Oklahoma,40039,8343,171,8514
7/24/2022,Delaware,Oklahoma,40041,11770,204,11974
7/24/2022,Dewey,Oklahoma,40043,1104,33,1137
7/24/2022,Ellis,Oklahoma,40045,856,11,867
7/24/2022,Garfield,Oklahoma,40047,15728,297,16025
7/24/2022,Garvin,Oklahoma,40049,7417,149,7566
7/24/2022,Grady,Oklahoma,40051,14387,250,14637
7/24/2022,Grant,Oklahoma,40053,1074,16,1090
7/24/2022,Greer,Oklahoma,40055,1343,37,1380
7/24/2022,Harmon,Oklahoma,40057,554,12,566
7/24/2022,Harper,Oklahoma,40059,746,12,758
7/24/2022,Haskell,Oklahoma,40061,2926,42,2968
7/24/2022,Hughes,Oklahoma,40063,2743,63,2806
7/24/2022,Jackson,Oklahoma,40065,6929,108,7037
7/24/2022,Jefferson,Oklahoma,40067,1378,26,1404
7/24/2022,Johnston,Oklahoma,40069,3182,56,3238
7/24/2022,Kay,Oklahoma,40071,12991,217,13208
7/24/2022,Kingfisher,Oklahoma,40073,4309,71,4380
7/24/2022,Kiowa,Oklahoma,40075,2028,55,2083
7/24/2022,Latimer,Oklahoma,40077,2360,35,2395
7/24/2022,Le Flore,Oklahoma,40079,13211,107,13318
7/24/2022,Lincoln,Oklahoma,40081,8373,144,8517
7/24/2022,Logan,Oklahoma,40083,11636,163,11799
7/24/2022,Love,Oklahoma,40085,3297,40,3337
7/24/2022,Major,Oklahoma,40093,2574,41,2615
7/24/2022,Marshall,Oklahoma,40095,4855,46,4901
7/24/2022,Mayes,Oklahoma,40097,11029,164,11193
7/24/2022,McClain,Oklahoma,40087,12340,139,12479
7/24/2022,McCurtain,Oklahoma,40089,8368,166,8534
7/24/2022,McIntosh,Oklahoma,40091,5106,125,5231
7/24/2022,Murray,Oklahoma,40099,4399,79,4478
7/24/2022,Muskogee,Oklahoma,40101,21158,353,21511
7/24/2022,Noble,Oklahoma,40103,3177,41,3218
7/24/2022,Nowata,Oklahoma,40105,2884,42,2926
7/24/2022,Okfuskee,Oklahoma,40107,3683,62,3745
7/24/2022,Oklahoma,Oklahoma,40109,213050,2504,215554
7/24/2022,Okmulgee,Oklahoma,40111,10125,193,10318
7/24/2022,Osage,Oklahoma,40113,11696,171,11867
7/24/2022,Ottawa,Oklahoma,40115,9860,127,9987
7/24/2022,Pawnee,Oklahoma,40117,4358,85,4443
7/24/2022,Payne,Oklahoma,40119,19656,168,19824
7/24/2022,Pittsburg,Oklahoma,40121,11461,214,11675
7/24/2022,Pontotoc,Oklahoma,40123,13113,154,13267
7/24/2022,Pottawatomie,Oklahoma,40125,22020,284,22304
7/24/2022,Pushmataha,Oklahoma,40127,2798,45,2843
7/24/2022,Roger Mills,Oklahoma,40129,928,16,944
7/24/2022,Rogers,Oklahoma,40131,26941,391,27332
7/24/2022,Seminole,Oklahoma,40133,6488,136,6624
7/24/2022,Sequoyah,Oklahoma,40135,11344,107,11451
7/24/2022,Stephens,Oklahoma,40137,11833,208,12041
7/24/2022,Texas,Oklahoma,40139,6219,56,6275
7/24/2022,Tillman,Oklahoma,40141,1597,36,1633
7/24/2022,Tulsa,Oklahoma,40143,183093,2206,185299
7/24/2022,Unknown,Oklahoma,,4546,0,4546
7/24/2022,Wagoner,Oklahoma,40145,23329,277,23606
7/24/2022,Washington,Oklahoma,40147,13413,264,13677
7/24/2022,Washita,Oklahoma,40149,2750,56,2806
7/24/2022,Woods,Oklahoma,40151,2428,38,2466
7/24/2022,Woodward,Oklahoma,40153,5405,79,5484
7/24/2022,Baker,Oregon,41001,3479,50,3529
7/24/2022,Benton,Oregon,41003,19159,74,19233
7/24/2022,Clackamas,Oregon,41005,73581,682,74263
7/24/2022,Clatsop,Oregon,41007,5579,54,5633
7/24/2022,Columbia,Oregon,41009,9059,98,9157
7/24/2022,Coos,Oregon,41011,12406,165,12571
7/24/2022,Crook,Oregon,41013,6939,86,7025
7/24/2022,Curry,Oregon,41015,4007,62,4069
7/24/2022,Deschutes,Oregon,41017,54635,308,54943
7/24/2022,Douglas,Oregon,41019,22396,414,22810
7/24/2022,Gilliam,Oregon,41021,290,6,296
7/24/2022,Grant,Oregon,41023,1952,22,1974
7/24/2022,Harney,Oregon,41025,1723,41,1764
7/24/2022,Hood River,Oregon,41027,4188,45,4233
7/24/2022,Jackson,Oregon,41029,48278,559,48837
7/24/2022,Jefferson,Oregon,41031,7929,98,8027
7/24/2022,Josephine,Oregon,41033,18133,354,18487
7/24/2022,Klamath,Oregon,41035,15836,230,16066
7/24/2022,Lake,Oregon,41037,1507,29,1536
7/24/2022,Lane,Oregon,41039,68753,583,69336
7/24/2022,Lincoln,Oregon,41041,8140,92,8232
7/24/2022,Linn,Oregon,41043,29776,285,30061
7/24/2022,Malheur,Oregon,41045,8667,109,8776
7/24/2022,Marion,Oregon,41047,78398,755,79153
7/24/2022,Morrow,Oregon,41049,3132,35,3167
7/24/2022,Multnomah,Oregon,41051,147739,1289,149028
7/24/2022,Polk,Oregon,41053,17929,141,18070
7/24/2022,Sherman,Oregon,41055,355,6,361
7/24/2022,Tillamook,Oregon,41057,4405,67,4472
7/24/2022,Umatilla,Oregon,41059,23910,235,24145
7/24/2022,Union,Oregon,41061,5365,84,5449
7/24/2022,Unknown,Oregon,,1,0,1
7/24/2022,Wallowa,Oregon,41063,1359,16,1375
7/24/2022,Wasco,Oregon,41065,5936,66,6002
7/24/2022,Washington,Oregon,41067,106968,648,107616
7/24/2022,Wheeler,Oregon,41069,255,3,258
7/24/2022,Yamhill,Oregon,41071,20188,231,20419
7/24/2022,Adams,Pennsylvania,42001,26881,381,27262
7/24/2022,Allegheny,Pennsylvania,42003,297003,3434,300437
7/24/2022,Armstrong,Pennsylvania,42005,16174,356,16530
7/24/2022,Beaver,Pennsylvania,42007,43354,763,44117
7/24/2022,Bedford,Pennsylvania,42009,11482,281,11763
7/24/2022,Berks,Pennsylvania,42011,110122,1629,111751
7/24/2022,Blair,Pennsylvania,42013,31299,637,31936
7/24/2022,Bradford,Pennsylvania,42015,17384,214,17598
7/24/2022,Bucks,Pennsylvania,42017,136655,1966,138621
7/24/2022,Butler,Pennsylvania,42019,48176,756,48932
7/24/2022,Cambria,Pennsylvania,42021,37026,750,37776
7/24/2022,Cameron,Pennsylvania,42023,880,21,901
7/24/2022,Carbon,Pennsylvania,42025,17242,308,17550
7/24/2022,Centre,Pennsylvania,42027,38491,361,38852
7/24/2022,Chester,Pennsylvania,42029,103243,1194,104437
7/24/2022,Clarion,Pennsylvania,42031,8728,209,8937
7/24/2022,Clearfield,Pennsylvania,42033,20686,355,21041
7/24/2022,Clinton,Pennsylvania,42035,9754,130,9884
7/24/2022,Columbia,Pennsylvania,42037,16554,253,16807
7/24/2022,Crawford,Pennsylvania,42039,21320,332,21652
7/24/2022,Cumberland,Pennsylvania,42041,55299,914,56213
7/24/2022,Dauphin,Pennsylvania,42043,63514,989,64503
7/24/2022,Delaware,Pennsylvania,42045,123472,1907,125379
7/24/2022,Elk,Pennsylvania,42047,7555,104,7659
7/24/2022,Erie,Pennsylvania,42049,62453,795,63248
7/24/2022,Fayette,Pennsylvania,42051,33381,688,34069
7/24/2022,Forest,Pennsylvania,42053,2316,35,2351
7/24/2022,Franklin,Pennsylvania,42055,43350,711,44061
7/24/2022,Fulton,Pennsylvania,42057,4345,66,4411
7/24/2022,Greene,Pennsylvania,42059,9051,107,9158
7/24/2022,Huntingdon,Pennsylvania,42061,12127,256,12383
7/24/2022,Indiana,Pennsylvania,42063,18809,370,19179
7/24/2022,Jefferson,Pennsylvania,42065,9609,246,9855
7/24/2022,Juniata,Pennsylvania,42067,5043,180,5223
7/24/2022,Lackawanna,Pennsylvania,42069,49274,808,50082
7/24/2022,Lancaster,Pennsylvania,42071,130175,1939,132114
7/24/2022,Lawrence,Pennsylvania,42073,20116,427,20543
7/24/2022,Lebanon,Pennsylvania,42075,39225,527,39752
7/24/2022,Lehigh,Pennsylvania,42077,97567,1279,98846
7/24/2022,Luzerne,Pennsylvania,42079,80996,1433,82429
7/24/2022,Lycoming,Pennsylvania,42081,30651,542,31193
7/24/2022,McKean,Pennsylvania,42083,8678,151,8829
7/24/2022,Mercer,Pennsylvania,42085,24898,510,25408
7/24/2022,Mifflin,Pennsylvania,42087,12964,282,13246
7/24/2022,Monroe,Pennsylvania,42089,41061,545,41606
7/24/2022,Montgomery,Pennsylvania,42091,173660,2396,176056
7/24/2022,Montour,Pennsylvania,42093,5030,94,5124
7/24/2022,Northampton,Pennsylvania,42095,87109,1133,88242
7/24/2022,Northumberland,Pennsylvania,42097,24618,547,25165
7/24/2022,Perry,Pennsylvania,42099,9314,189,9503
7/24/2022,Philadelphia,Pennsylvania,42101,342727,5200,347927
7/24/2022,Pike,Pennsylvania,42103,11335,101,11436
7/24/2022,Potter,Pennsylvania,42105,3429,93,3522
7/24/2022,Schuylkill,Pennsylvania,42107,36801,697,37498
7/24/2022,Snyder,Pennsylvania,42109,8548,160,8708
7/24/2022,Somerset,Pennsylvania,42111,19804,415,20219
7/24/2022,Sullivan,Pennsylvania,42113,1158,36,1194
7/24/2022,Susquehanna,Pennsylvania,42115,8680,115,8795
7/24/2022,Tioga,Pennsylvania,42117,8789,200,8989
7/24/2022,Union,Pennsylvania,42119,12364,156,12520
7/24/2022,Venango,Pennsylvania,42121,12029,249,12278
7/24/2022,Warren,Pennsylvania,42123,8097,218,8315
7/24/2022,Washington,Pennsylvania,42125,55645,670,56315
7/24/2022,Wayne,Pennsylvania,42127,11171,177,11348
7/24/2022,Westmoreland,Pennsylvania,42129,86301,1414,87715
7/24/2022,Wyoming,Pennsylvania,42131,5638,114,5752
7/24/2022,York,Pennsylvania,42133,127686,1532,129218
7/24/2022,Adjuntas,Puerto Rico,72001,4651,,4651
7/24/2022,Aguada,Puerto Rico,72003,10116,,10116
7/24/2022,Aguadilla,Puerto Rico,72005,12298,,12298
7/24/2022,Aguas Buenas,Puerto Rico,72007,6510,,6510
7/24/2022,Aibonito,Puerto Rico,72009,6289,,6289
7/24/2022,Anasco,Puerto Rico,72011,6380,,6380
7/24/2022,Arecibo,Puerto Rico,72013,20673,,20673
7/24/2022,Arroyo,Puerto Rico,72015,4157,,4157
7/24/2022,Barceloneta,Puerto Rico,72017,5876,,5876
7/24/2022,Barranquitas,Puerto Rico,72019,7685,,7685
7/24/2022,Bayamon,Puerto Rico,72021,53125,,53125
7/24/2022,Cabo Rojo,Puerto Rico,72023,9919,,9919
7/24/2022,Caguas,Puerto Rico,72025,34966,,34966
7/24/2022,Camuy,Puerto Rico,72027,8452,,8452
7/24/2022,Canovanas,Puerto Rico,72029,10396,,10396
7/24/2022,Carolina,Puerto Rico,72031,42189,,42189
7/24/2022,Catano,Puerto Rico,72033,6072,,6072
7/24/2022,Cayey,Puerto Rico,72035,10995,,10995
7/24/2022,Ceiba,Puerto Rico,72037,2527,,2527
7/24/2022,Ciales,Puerto Rico,72039,4138,,4138
7/24/2022,Cidra,Puerto Rico,72041,10625,,10625
7/24/2022,Coamo,Puerto Rico,72043,9016,,9016
7/24/2022,Comerio,Puerto Rico,72045,4743,,4743
7/24/2022,Corozal,Puerto Rico,72047,9683,,9683
7/24/2022,Culebra,Puerto Rico,72049,361,,361
7/24/2022,Dorado,Puerto Rico,72051,10336,,10336
7/24/2022,Fajardo,Puerto Rico,72053,7681,,7681
7/24/2022,Florida,Puerto Rico,72054,3857,,3857
7/24/2022,Guanica,Puerto Rico,72055,2677,,2677
7/24/2022,Guayama,Puerto Rico,72057,8997,,8997
7/24/2022,Guayanilla,Puerto Rico,72059,4333,,4333
7/24/2022,Guaynabo,Puerto Rico,72061,24774,,24774
7/24/2022,Gurabo,Puerto Rico,72063,11786,,11786
7/24/2022,Hatillo,Puerto Rico,72065,8877,,8877
7/24/2022,Hormigueros,Puerto Rico,72067,3721,,3721
7/24/2022,Humacao,Puerto Rico,72069,13060,,13060
7/24/2022,Isabela,Puerto Rico,72071,11154,,11154
7/24/2022,Jayuya,Puerto Rico,72073,4235,,4235
7/24/2022,Juana Diaz,Puerto Rico,72075,11073,,11073
7/24/2022,Juncos,Puerto Rico,72077,10158,,10158
7/24/2022,Lajas,Puerto Rico,72079,5051,,5051
7/24/2022,Lares,Puerto Rico,72081,7796,,7796
7/24/2022,Las Marias,Puerto Rico,72083,2283,,2283
7/24/2022,Las Piedras,Puerto Rico,72085,9307,,9307
7/24/2022,Loiza,Puerto Rico,72087,4791,,4791
7/24/2022,Luquillo,Puerto Rico,72089,4201,,4201
7/24/2022,Manati,Puerto Rico,72091,9886,,9886
7/24/2022,Maricao,Puerto Rico,72093,1149,,1149
7/24/2022,Maunabo,Puerto Rico,72095,2479,,2479
7/24/2022,Mayaguez,Puerto Rico,72097,16750,,16750
7/24/2022,Moca,Puerto Rico,72099,10356,,10356
7/24/2022,Morovis,Puerto Rico,72101,7441,,7441
7/24/2022,Naguabo,Puerto Rico,72103,5747,,5747
7/24/2022,Naranjito,Puerto Rico,72105,7832,,7832
7/24/2022,Orocovis,Puerto Rico,72107,5126,,5126
7/24/2022,Patillas,Puerto Rico,72109,4063,,4063
7/24/2022,Penuelas,Puerto Rico,72111,4364,,4364
7/24/2022,Ponce,Puerto Rico,72113,30752,,30752
7/24/2022,Quebradillas,Puerto Rico,72115,6740,,6740
7/24/2022,Rincon,Puerto Rico,72117,3449,,3449
7/24/2022,Rio Grande,Puerto Rico,72119,11634,,11634
7/24/2022,Sabana Grande,Puerto Rico,72121,4715,,4715
7/24/2022,Salinas,Puerto Rico,72123,6174,,6174
7/24/2022,San German,Puerto Rico,72125,6753,,6753
7/24/2022,San Juan,Puerto Rico,72127,85006,,85006
7/24/2022,San Lorenzo,Puerto Rico,72129,9262,,9262
7/24/2022,San Sebastian,Puerto Rico,72131,10828,,10828
7/24/2022,Santa Isabel,Puerto Rico,72133,5056,,5056
7/24/2022,Toa Alta,Puerto Rico,72135,18059,,18059
7/24/2022,Toa Baja,Puerto Rico,72137,19742,,19742
7/24/2022,Trujillo Alto,Puerto Rico,72139,15604,,15604
7/24/2022,Unknown,Puerto Rico,,30134,4723,34857
7/24/2022,Utuado,Puerto Rico,72141,6093,,6093
7/24/2022,Vega Alta,Puerto Rico,72143,9773,,9773
7/24/2022,Vega Baja,Puerto Rico,72145,16076,,16076
7/24/2022,Vieques,Puerto Rico,72147,1436,,1436
7/24/2022,Villalba,Puerto Rico,72149,6021,,6021
7/24/2022,Yabucoa,Puerto Rico,72151,8038,,8038
7/24/2022,Yauco,Puerto Rico,72153,8462,,8462
7/24/2022,Bristol,Rhode Island,44001,15749,178,15927
7/24/2022,Kent,Rhode Island,44003,55769,519,56288
7/24/2022,Newport,Rhode Island,44005,23352,96,23448
7/24/2022,Providence,Rhode Island,44007,246126,2585,248711
7/24/2022,Unknown,Rhode Island,,29520,6,29526
7/24/2022,Washington,Rhode Island,44009,38016,242,38258
7/24/2022,Abbeville,South Carolina,45001,6903,69,6972
7/24/2022,Aiken,South Carolina,45003,44774,442,45216
7/24/2022,Allendale,South Carolina,45005,2176,24,2200
7/24/2022,Anderson,South Carolina,45007,60831,1014,61845
7/24/2022,Bamberg,South Carolina,45009,3725,75,3800
7/24/2022,Barnwell,South Carolina,45011,6111,103,6214
7/24/2022,Beaufort,South Carolina,45013,46997,386,47383
7/24/2022,Berkeley,South Carolina,45015,56927,455,57382
7/24/2022,Calhoun,South Carolina,45017,3008,61,3069
7/24/2022,Charleston,South Carolina,45019,122906,969,123875
7/24/2022,Cherokee,South Carolina,45021,15566,323,15889
7/24/2022,Chester,South Carolina,45023,10754,155,10909
7/24/2022,Chesterfield,South Carolina,45025,12866,196,13062
7/24/2022,Clarendon,South Carolina,45027,9479,161,9640
7/24/2022,Colleton,South Carolina,45029,9595,222,9817
7/24/2022,Darlington,South Carolina,45031,20070,314,20384
7/24/2022,Dillon,South Carolina,45033,10358,145,10503
7/24/2022,Dorchester,South Carolina,45035,61052,510,61562
7/24/2022,Edgefield,South Carolina,45037,7216,71,7287
7/24/2022,Fairfield,South Carolina,45039,6425,110,6535
7/24/2022,Florence,South Carolina,45041,44659,643,45302
7/24/2022,Georgetown,South Carolina,45043,17086,230,17316
7/24/2022,Greenville,South Carolina,45045,182841,2032,184873
7/24/2022,Greenwood,South Carolina,45047,23338,312,23650
7/24/2022,Hampton,South Carolina,45049,5293,86,5379
7/24/2022,Horry,South Carolina,45051,105638,1177,106815
7/24/2022,Jasper,South Carolina,45053,6310,93,6403
7/24/2022,Kershaw,South Carolina,45055,23500,264,23764
7/24/2022,Lancaster,South Carolina,45057,27193,282,27475
7/24/2022,Laurens,South Carolina,45059,19551,298,19849
7/24/2022,Lee,South Carolina,45061,4576,96,4672
7/24/2022,Lexington,South Carolina,45063,104246,890,105136
7/24/2022,Marion,South Carolina,45067,9320,166,9486
7/24/2022,Marlboro,South Carolina,45069,8549,106,8655
7/24/2022,McCormick,South Carolina,45065,2345,40,2385
7/24/2022,Newberry,South Carolina,45071,14115,201,14316
7/24/2022,Oconee,South Carolina,45073,25596,350,25946
7/24/2022,Orangeburg,South Carolina,45075,25279,424,25703
7/24/2022,Pickens,South Carolina,45077,48219,641,48860
7/24/2022,Richland,South Carolina,45079,135949,963,136912
7/24/2022,Saluda,South Carolina,45081,4098,78,4176
7/24/2022,Spartanburg,South Carolina,45083,100354,1560,101914
7/24/2022,Sumter,South Carolina,45085,30771,405,31176
7/24/2022,Union,South Carolina,45087,8172,154,8326
7/24/2022,Williamsburg,South Carolina,45089,9113,146,9259
7/24/2022,York,South Carolina,45091,83653,690,84343
7/24/2022,Aurora,South Dakota,46003,831,17,848
7/24/2022,Beadle,South Dakota,46005,4882,60,4942
7/24/2022,Bennett,South Dakota,46007,812,15,827
7/24/2022,Bon Homme,South Dakota,46009,2327,39,2366
7/24/2022,Brookings,South Dakota,46011,8501,56,8557
7/24/2022,Brown,South Dakota,46013,10705,121,10826
7/24/2022,Brule,South Dakota,46015,1495,22,1517
7/24/2022,Buffalo,South Dakota,46017,626,18,644
7/24/2022,Butte,South Dakota,46019,2907,47,2954
7/24/2022,Campbell,South Dakota,46021,282,7,289
7/24/2022,Charles Mix,South Dakota,46023,3034,35,3069
7/24/2022,Clark,South Dakota,46025,830,10,840
7/24/2022,Clay,South Dakota,46027,3601,22,3623
7/24/2022,Codington,South Dakota,46029,8970,101,9071
7/24/2022,Corson,South Dakota,46031,1088,17,1105
7/24/2022,Custer,South Dakota,46033,2222,26,2248
7/24/2022,Davison,South Dakota,46035,6127,81,6208
7/24/2022,Day,South Dakota,46037,1324,35,1359
7/24/2022,Deuel,South Dakota,46039,1077,12,1089
7/24/2022,Dewey,South Dakota,46041,3148,44,3192
7/24/2022,Douglas,South Dakota,46043,703,16,719
7/24/2022,Edmunds,South Dakota,46045,972,16,988
7/24/2022,Fall River,South Dakota,46047,2045,40,2085
7/24/2022,Faulk,South Dakota,46049,603,17,620
7/24/2022,Grant,South Dakota,46051,2123,51,2174
7/24/2022,Gregory,South Dakota,46053,1091,34,1125
7/24/2022,Haakon,South Dakota,46055,483,12,495
7/24/2022,Hamlin,South Dakota,46057,1625,41,1666
7/24/2022,Hand,South Dakota,46059,607,13,620
7/24/2022,Hanson,South Dakota,46061,674,6,680
7/24/2022,Harding,South Dakota,46063,209,3,212
7/24/2022,Hughes,South Dakota,46065,4531,58,4589
7/24/2022,Hutchinson,South Dakota,46067,1810,36,1846
7/24/2022,Hyde,South Dakota,46069,318,8,326
7/24/2022,Jackson,South Dakota,46071,648,21,669
7/24/2022,Jerauld,South Dakota,46073,426,20,446
7/24/2022,Jones,South Dakota,46075,181,2,183
7/24/2022,Kingsbury,South Dakota,46077,1370,22,1392
7/24/2022,Lake,South Dakota,46079,2400,28,2428
7/24/2022,Lawrence,South Dakota,46081,7031,84,7115
7/24/2022,Lincoln,South Dakota,46083,16093,102,16195
7/24/2022,Lyman,South Dakota,46085,1268,12,1280
7/24/2022,Marshall,South Dakota,46091,820,13,833
7/24/2022,McCook,South Dakota,46087,1369,31,1400
7/24/2022,McPherson,South Dakota,46089,444,9,453
7/24/2022,Meade,South Dakota,46093,7455,64,7519
7/24/2022,Mellette,South Dakota,46095,537,8,545
7/24/2022,Miner,South Dakota,46097,480,13,493
7/24/2022,Minnehaha,South Dakota,46099,59342,526,59868
7/24/2022,Moody,South Dakota,46101,1459,28,1487
7/24/2022,Oglala Lakota,South Dakota,46102,4116,61,4177
7/24/2022,Pennington,South Dakota,46103,34956,348,35304
7/24/2022,Perkins,South Dakota,46105,724,18,742
7/24/2022,Potter,South Dakota,46107,709,7,716
7/24/2022,Roberts,South Dakota,46109,2500,53,2553
7/24/2022,Sanborn,South Dakota,46111,610,7,617
7/24/2022,Spink,South Dakota,46115,1466,36,1502
7/24/2022,Stanley,South Dakota,46117,664,8,672
7/24/2022,Sully,South Dakota,46119,253,3,256
7/24/2022,Todd,South Dakota,46121,3066,52,3118
7/24/2022,Tripp,South Dakota,46123,1454,25,1479
7/24/2022,Turner,South Dakota,46125,2034,62,2096
7/24/2022,Union,South Dakota,46127,4104,52,4156
7/24/2022,Walworth,South Dakota,46129,1378,26,1404
7/24/2022,Yankton,South Dakota,46135,6176,59,6235
7/24/2022,Ziebach,South Dakota,46137,672,11,683
7/24/2022,Anderson,Tennessee,47001,23471,349,23820
7/24/2022,Bedford,Tennessee,47003,15676,240,15916
7/24/2022,Benton,Tennessee,47005,4839,94,4933
7/24/2022,Bledsoe,Tennessee,47007,4798,61,4859
7/24/2022,Blount,Tennessee,47009,41456,454,41910
7/24/2022,Bradley,Tennessee,47011,34728,423,35151
7/24/2022,Campbell,Tennessee,47013,12984,171,13155
7/24/2022,Cannon,Tennessee,47015,4441,68,4509
7/24/2022,Carroll,Tennessee,47017,9610,159,9769
7/24/2022,Carter,Tennessee,47019,17406,342,17748
7/24/2022,Cheatham,Tennessee,47021,11530,127,11657
7/24/2022,Chester,Tennessee,47023,6153,99,6252
7/24/2022,Claiborne,Tennessee,47025,9442,184,9626
7/24/2022,Clay,Tennessee,47027,2374,52,2426
7/24/2022,Cocke,Tennessee,47029,12252,226,12478
7/24/2022,Coffee,Tennessee,47031,17893,273,18166
7/24/2022,Crockett,Tennessee,47033,5475,88,5563
7/24/2022,Cumberland,Tennessee,47035,16987,330,17317
7/24/2022,Davidson,Tennessee,47037,227237,1720,228957
7/24/2022,Decatur,Tennessee,47039,3917,71,3988
7/24/2022,DeKalb,Tennessee,47041,6600,102,6702
7/24/2022,Dickson,Tennessee,47043,16889,245,17134
7/24/2022,Dyer,Tennessee,47045,13616,212,13828
7/24/2022,Fayette,Tennessee,47047,12387,191,12578
7/24/2022,Fentress,Tennessee,47049,5954,130,6084
7/24/2022,Franklin,Tennessee,47051,13539,188,13727
7/24/2022,Gibson,Tennessee,47053,18539,264,18803
7/24/2022,Giles,Tennessee,47055,9929,197,10126
7/24/2022,Grainger,Tennessee,47057,7082,111,7193
7/24/2022,Greene,Tennessee,47059,23162,379,23541
7/24/2022,Grundy,Tennessee,47061,4164,75,4239
7/24/2022,Hamblen,Tennessee,47063,20752,366,21118
7/24/2022,Hamilton,Tennessee,47065,108501,1186,109687
7/24/2022,Hancock,Tennessee,47067,2106,37,2143
7/24/2022,Hardeman,Tennessee,47069,8096,120,8216
7/24/2022,Hardin,Tennessee,47071,9378,155,9533
7/24/2022,Hawkins,Tennessee,47073,17439,332,17771
7/24/2022,Haywood,Tennessee,47075,6642,103,6745
7/24/2022,Henderson,Tennessee,47077,9518,166,9684
7/24/2022,Henry,Tennessee,47079,8736,165,8901
7/24/2022,Hickman,Tennessee,47081,7272,111,7383
7/24/2022,Houston,Tennessee,47083,2765,62,2827
7/24/2022,Humphreys,Tennessee,47085,5123,77,5200
7/24/2022,Jackson,Tennessee,47087,3338,63,3401
7/24/2022,Jefferson,Tennessee,47089,16633,278,16911
7/24/2022,Johnson,Tennessee,47091,5401,97,5498
7/24/2022,Knox,Tennessee,47093,137003,1429,138432
7/24/2022,Lake,Tennessee,47095,2841,44,2885
7/24/2022,Lauderdale,Tennessee,47097,8194,108,8302
7/24/2022,Lawrence,Tennessee,47099,14872,208,15080
7/24/2022,Lewis,Tennessee,47101,3686,61,3747
7/24/2022,Lincoln,Tennessee,47103,10425,175,10600
7/24/2022,Loudon,Tennessee,47105,15443,195,15638
7/24/2022,Macon,Tennessee,47111,8888,147,9035
7/24/2022,Madison,Tennessee,47113,32574,434,33008
7/24/2022,Marion,Tennessee,47115,9392,133,9525
7/24/2022,Marshall,Tennessee,47117,10873,125,10998
7/24/2022,Maury,Tennessee,47119,30834,354,31188
7/24/2022,McMinn,Tennessee,47107,17463,269,17732
7/24/2022,McNairy,Tennessee,47109,8229,127,8356
7/24/2022,Meigs,Tennessee,47121,3557,59,3616
7/24/2022,Monroe,Tennessee,47123,15331,250,15581
7/24/2022,Montgomery,Tennessee,47125,53627,590,54217
7/24/2022,Moore,Tennessee,47127,2331,40,2371
7/24/2022,Morgan,Tennessee,47129,6446,88,6534
7/24/2022,Obion,Tennessee,47131,11495,203,11698
7/24/2022,Overton,Tennessee,47133,7506,126,7632
7/24/2022,Perry,Tennessee,47135,2444,56,2500
7/24/2022,Pickett,Tennessee,47137,1885,37,1922
7/24/2022,Polk,Tennessee,47139,4960,82,5042
7/24/2022,Putnam,Tennessee,47141,26232,306,26538
7/24/2022,Rhea,Tennessee,47143,10455,161,10616
7/24/2022,Roane,Tennessee,47145,16649,237,16886
7/24/2022,Robertson,Tennessee,47147,22688,311,22999
7/24/2022,Rutherford,Tennessee,47149,102465,918,103383
7/24/2022,Scott,Tennessee,47151,9650,121,9771
7/24/2022,Sequatchie,Tennessee,47153,4463,70,4533
7/24/2022,Sevier,Tennessee,47155,32030,424,32454
7/24/2022,Shelby,Tennessee,47157,263252,3394,266646
7/24/2022,Smith,Tennessee,47159,6451,87,6538
7/24/2022,Stewart,Tennessee,47161,3413,63,3476
7/24/2022,Sullivan,Tennessee,47163,48857,734,49591
7/24/2022,Sumner,Tennessee,47165,56924,745,57669
7/24/2022,Tipton,Tennessee,47167,19045,238,19283
7/24/2022,Trousdale,Tennessee,47169,4342,47,4389
7/24/2022,Unicoi,Tennessee,47171,5470,97,5567
7/24/2022,Union,Tennessee,47173,5791,78,5869
7/24/2022,Unknown,Tennessee,,28114,337,28451
7/24/2022,Van Buren,Tennessee,47175,1916,48,1964
7/24/2022,Warren,Tennessee,47177,13642,181,13823
7/24/2022,Washington,Tennessee,47179,41077,505,41582
7/24/2022,Wayne,Tennessee,47181,5927,72,5999
7/24/2022,Weakley,Tennessee,47183,10087,162,10249
7/24/2022,White,Tennessee,47185,8589,130,8719
7/24/2022,Williamson,Tennessee,47187,67450,415,67865
7/24/2022,Wilson,Tennessee,47189,44772,500,45272
7/24/2022,Anderson,Texas,48001,10001,240,10241
7/24/2022,Andrews,Texas,48003,4118,72,4190
7/24/2022,Angelina,Texas,48005,16009,485,16494
7/24/2022,Aransas,Texas,48007,4718,88,4806
7/24/2022,Archer,Texas,48009,2366,28,2394
7/24/2022,Armstrong,Texas,48011,602,10,612
7/24/2022,Atascosa,Texas,48013,14440,233,14673
7/24/2022,Austin,Texas,48015,6296,75,6371
7/24/2022,Bailey,Texas,48017,1657,39,1696
7/24/2022,Bandera,Texas,48019,3893,78,3971
7/24/2022,Bastrop,Texas,48021,23953,240,24193
7/24/2022,Baylor,Texas,48023,846,32,878
7/24/2022,Bee,Texas,48025,9007,154,9161
7/24/2022,Bell,Texas,48027,73501,915,74416
7/24/2022,Bexar,Texas,48029,616259,6210,622469
7/24/2022,Blanco,Texas,48031,2813,34,2847
7/24/2022,Borden,Texas,48033,107,2,109
7/24/2022,Bosque,Texas,48035,4327,70,4397
7/24/2022,Bowie,Texas,48037,21492,438,21930
7/24/2022,Brazoria,Texas,48039,104626,992,105618
7/24/2022,Brazos,Texas,48041,66208,419,66627
7/24/2022,Brewster,Texas,48043,1155,31,1186
7/24/2022,Briscoe,Texas,48045,484,8,492
7/24/2022,Brooks,Texas,48047,1786,52,1838
7/24/2022,Brown,Texas,48049,12681,229,12910
7/24/2022,Burleson,Texas,48051,5349,67,5416
7/24/2022,Burnet,Texas,48053,11982,173,12155
7/24/2022,Caldwell,Texas,48055,15734,178,15912
7/24/2022,Calhoun,Texas,48057,6209,51,6260
7/24/2022,Callahan,Texas,48059,3115,72,3187
7/24/2022,Cameron,Texas,48061,117494,2053,119547
7/24/2022,Camp,Texas,48063,3031,75,3106
7/24/2022,Carson,Texas,48065,1589,37,1626
7/24/2022,Cass,Texas,48067,7635,197,7832
7/24/2022,Castro,Texas,48069,2407,47,2454
7/24/2022,Chambers,Texas,48071,12867,113,12980
7/24/2022,Cherokee,Texas,48073,8410,254,8664
7/24/2022,Childress,Texas,48075,2745,34,2779
7/24/2022,Clay,Texas,48077,2276,38,2314
7/24/2022,Cochran,Texas,48079,912,23,935
7/24/2022,Coke,Texas,48081,938,20,958
7/24/2022,Coleman,Texas,48083,1731,71,1802
7/24/2022,Collin,Texas,48085,237410,1521,238931
7/24/2022,Collingsworth,Texas,48087,740,16,756
7/24/2022,Colorado,Texas,48089,4032,66,4098
7/24/2022,Comal,Texas,48091,38081,562,38643
7/24/2022,Comanche,Texas,48093,3791,78,3869
7/24/2022,Concho,Texas,48095,1173,11,1184
7/24/2022,Cooke,Texas,48097,7750,134,7884
7/24/2022,Coryell,Texas,48099,18743,215,18958
7/24/2022,Cottle,Texas,48101,343,9,352
7/24/2022,Crane,Texas,48103,1353,24,1377
7/24/2022,Crockett,Texas,48105,1166,20,1186
7/24/2022,Crosby,Texas,48107,1976,45,2021
7/24/2022,Culberson,Texas,48109,521,14,535
7/24/2022,Dallam,Texas,48111,2224,40,2264
7/24/2022,Dallas,Texas,48113,615706,6810,622516
7/24/2022,Dawson,Texas,48115,3081,95,3176
7/24/2022,Deaf Smith,Texas,48117,5035,115,5150
7/24/2022,Delta,Texas,48119,1891,27,1918
7/24/2022,Denton,Texas,48121,196333,1370,197703
7/24/2022,DeWitt,Texas,48123,6791,100,6891
7/24/2022,Dickens,Texas,48125,474,16,490
7/24/2022,Dimmit,Texas,48127,5976,51,6027
7/24/2022,Donley,Texas,48129,1185,26,1211
7/24/2022,Duval,Texas,48131,3754,70,3824
7/24/2022,Eastland,Texas,48133,2932,113,3045
7/24/2022,Ector,Texas,48135,39136,709,39845
7/24/2022,Edwards,Texas,48137,502,11,513
7/24/2022,Ellis,Texas,48139,52047,587,52634
7/24/2022,El Paso,Texas,48141,225694,3762,229456
7/24/2022,Erath,Texas,48143,9070,124,9194
7/24/2022,Falls,Texas,48145,3982,67,4049
7/24/2022,Fannin,Texas,48147,7213,183,7396
7/24/2022,Fayette,Texas,48149,5064,109,5173
7/24/2022,Fisher,Texas,48151,632,24,656
7/24/2022,Floyd,Texas,48153,2050,48,2098
7/24/2022,Foard,Texas,48155,224,11,235
7/24/2022,Fort Bend,Texas,48157,216914,1277,218191
7/24/2022,Franklin,Texas,48159,2321,45,2366
7/24/2022,Freestone,Texas,48161,4007,82,4089
7/24/2022,Frio,Texas,48163,6242,94,6336
7/24/2022,Gaines,Texas,48165,2246,83,2329
7/24/2022,Galveston,Texas,48167,107887,865,108752
7/24/2022,Garza,Texas,48169,1326,29,1355
7/24/2022,Gillespie,Texas,48171,5728,109,5837
7/24/2022,Glasscock,Texas,48173,214,3,217
7/24/2022,Goliad,Texas,48175,1330,32,1362
7/24/2022,Gonzales,Texas,48177,4953,102,5055
7/24/2022,Gray,Texas,48179,6431,126,6557
7/24/2022,Grayson,Texas,48181,28469,647,29116
7/24/2022,Gregg,Texas,48183,24373,695,25068
7/24/2022,Grimes,Texas,48185,9171,125,9296
7/24/2022,Guadalupe,Texas,48187,41184,403,41587
7/24/2022,Hale,Texas,48189,7019,247,7266
7/24/2022,Hall,Texas,48191,1151,24,1175
7/24/2022,Hamilton,Texas,48193,1998,34,2032
7/24/2022,Hansford,Texas,48195,2063,29,2092
7/24/2022,Hardeman,Texas,48197,570,19,589
7/24/2022,Hardin,Texas,48199,13299,251,13550
7/24/2022,Harris,Texas,48201,1141547,11091,1152638
7/24/2022,Harrison,Texas,48203,14114,227,14341
7/24/2022,Hartley,Texas,48205,1394,3,1397
7/24/2022,Haskell,Texas,48207,942,39,981
7/24/2022,Hays,Texas,48209,68706,524,69230
7/24/2022,Hemphill,Texas,48211,1282,7,1289
7/24/2022,Henderson,Texas,48213,16168,428,16596
7/24/2022,Hidalgo,Texas,48215,228835,3937,232772
7/24/2022,Hill,Texas,48217,9315,195,9510
7/24/2022,Hockley,Texas,48219,8120,164,8284
7/24/2022,Hood,Texas,48221,13885,278,14163
7/24/2022,Hopkins,Texas,48223,7591,183,7774
7/24/2022,Houston,Texas,48225,4438,113,4551
7/24/2022,Howard,Texas,48227,7167,185,7352
7/24/2022,Hudspeth,Texas,48229,1095,18,1113
7/24/2022,Hunt,Texas,48231,16832,365,17197
7/24/2022,Hutchinson,Texas,48233,7007,136,7143
7/24/2022,Irion,Texas,48235,508,3,511
7/24/2022,Jack,Texas,48237,1577,28,1605
7/24/2022,Jackson,Texas,48239,3418,59,3477
7/24/2022,Jasper,Texas,48241,6942,190,7132
7/24/2022,Jeff Davis,Texas,48243,244,9,253
7/24/2022,Jefferson,Texas,48245,55713,855,56568
7/24/2022,Jim Hogg,Texas,48247,3089,22,3111
7/24/2022,Jim Wells,Texas,48249,12492,212,12704
7/24/2022,Johnson,Texas,48251,46308,744,47052
7/24/2022,Jones,Texas,48253,4819,93,4912
7/24/2022,Karnes,Texas,48255,6142,71,6213
7/24/2022,Kaufman,Texas,48257,37902,536,38438
7/24/2022,Kendall,Texas,48259,8913,124,9037
7/24/2022,Kenedy,Texas,48261,92,2,94
7/24/2022,Kent,Texas,48263,213,4,217
7/24/2022,Kerr,Texas,48265,10169,186,10355
7/24/2022,Kimble,Texas,48267,775,15,790
7/24/2022,King,Texas,48269,52,0,52
7/24/2022,Kinney,Texas,48271,776,11,787
7/24/2022,Kleberg,Texas,48273,8126,148,8274
7/24/2022,Knox,Texas,48275,542,25,567
7/24/2022,Lamar,Texas,48277,13241,259,13500
7/24/2022,Lamb,Texas,48279,4547,122,4669
7/24/2022,Lampasas,Texas,48281,5838,93,5931
7/24/2022,La Salle,Texas,48283,2472,49,2521
7/24/2022,Lavaca,Texas,48285,4462,121,4583
7/24/2022,Lee,Texas,48287,4590,61,4651
7/24/2022,Leon,Texas,48289,3880,93,3973
7/24/2022,Liberty,Texas,48291,19742,407,20149
7/24/2022,Limestone,Texas,48293,5391,124,5515
7/24/2022,Lipscomb,Texas,48295,748,17,765
7/24/2022,Live Oak,Texas,48297,2239,42,2281
7/24/2022,Llano,Texas,48299,4336,97,4433
7/24/2022,Loving,Texas,48301,281,1,282
7/24/2022,Lubbock,Texas,48303,99011,1342,100353
7/24/2022,Lynn,Texas,48305,1583,38,1621
7/24/2022,Madison,Texas,48313,3928,57,3985
7/24/2022,Marion,Texas,48315,1776,60,1836
7/24/2022,Martin,Texas,48317,1277,26,1303
7/24/2022,Mason,Texas,48319,851,12,863
7/24/2022,Matagorda,Texas,48321,9148,177,9325
7/24/2022,Maverick,Texas,48323,22105,471,22576
7/24/2022,McCulloch,Texas,48307,1409,47,1456
7/24/2022,McLennan,Texas,48309,65143,915,66058
7/24/2022,McMullen,Texas,48311,175,9,184
7/24/2022,Medina,Texas,48325,10886,200,11086
7/24/2022,Menard,Texas,48327,568,12,580
7/24/2022,Midland,Texas,48329,42792,498,43290
7/24/2022,Milam,Texas,48331,5281,104,5385
7/24/2022,Mills,Texas,48333,1491,37,1528
7/24/2022,Mitchell,Texas,48335,1943,49,1992
7/24/2022,Montague,Texas,48337,4866,129,4995
7/24/2022,Montgomery,Texas,48339,155148,1307,156455
7/24/2022,Moore,Texas,48341,5902,112,6014
7/24/2022,Morris,Texas,48343,2647,74,2721
7/24/2022,Motley,Texas,48345,293,13,306
7/24/2022,Nacogdoches,Texas,48347,13144,262,13406
7/24/2022,Navarro,Texas,48349,13027,223,13250
7/24/2022,Newton,Texas,48351,1508,62,1570
7/24/2022,Nolan,Texas,48353,3247,99,3346
7/24/2022,Nueces,Texas,48355,101961,1518,103479
7/24/2022,Ochiltree,Texas,48357,2509,48,2557
7/24/2022,Oldham,Texas,48359,585,6,591
7/24/2022,Orange,Texas,48361,16128,361,16489
7/24/2022,Palo Pinto,Texas,48363,7314,154,7468
7/24/2022,Panola,Texas,48365,4915,130,5045
7/24/2022,Parker,Texas,48367,36579,455,37034
7/24/2022,Parmer,Texas,48369,2468,53,2521
7/24/2022,Pecos,Texas,48371,2960,71,3031
7/24/2022,Pending County Assignment,Texas,,65,0,65
7/24/2022,Polk,Texas,48373,8415,249,8664
7/24/2022,Potter,Texas,48375,37713,748,38461
7/24/2022,Presidio,Texas,48377,1058,38,1096
7/24/2022,Rains,Texas,48379,1942,59,2001
7/24/2022,Randall,Texas,48381,40120,521,40641
7/24/2022,Reagan,Texas,48383,912,14,926
7/24/2022,Real,Texas,48385,890,25,915
7/24/2022,Red River,Texas,48387,2429,68,2497
7/24/2022,Reeves,Texas,48389,4920,74,4994
7/24/2022,Refugio,Texas,48391,1930,38,1968
7/24/2022,Roberts,Texas,48393,180,2,182
7/24/2022,Robertson,Texas,48395,4817,77,4894
7/24/2022,Rockwall,Texas,48397,28469,268,28737
7/24/2022,Runnels,Texas,48399,2489,68,2557
7/24/2022,Rusk,Texas,48401,11264,233,11497
7/24/2022,Sabine,Texas,48403,1349,89,1438
7/24/2022,San Augustine,Texas,48405,1122,45,1167
7/24/2022,San Jacinto,Texas,48407,6013,104,6117
7/24/2022,San Patricio,Texas,48409,12352,341,12693
7/24/2022,San Saba,Texas,48411,1298,35,1333
7/24/2022,Schleicher,Texas,48413,546,9,555
7/24/2022,Scurry,Texas,48415,5223,104,5327
7/24/2022,Shackelford,Texas,48417,720,12,732
7/24/2022,Shelby,Texas,48419,4679,134,4813
7/24/2022,Sherman,Texas,48421,507,16,523
7/24/2022,Smith,Texas,48423,48998,975,49973
7/24/2022,Somervell,Texas,48425,2135,36,2171
7/24/2022,Starr,Texas,48427,21407,366,21773
7/24/2022,Stephens,Texas,48429,1935,46,1981
7/24/2022,Sterling,Texas,48431,264,7,271
7/24/2022,Stonewall,Texas,48433,370,7,377
7/24/2022,Sutton,Texas,48435,863,12,875
7/24/2022,Swisher,Texas,48437,2371,34,2405
7/24/2022,Tarrant,Texas,48439,603628,5978,609606
7/24/2022,Taylor,Texas,48441,37433,731,38164
7/24/2022,Terrell,Texas,48443,131,3,134
7/24/2022,Terry,Texas,48445,2838,85,2923
7/24/2022,Throckmorton,Texas,48447,277,8,285
7/24/2022,Titus,Texas,48449,9028,129,9157
7/24/2022,Tom Green,Texas,48451,44305,555,44860
7/24/2022,Travis,Texas,48453,256606,1754,258360
7/24/2022,Trinity,Texas,48455,2871,73,2944
7/24/2022,Tyler,Texas,48457,4018,88,4106
7/24/2022,Upshur,Texas,48459,8211,187,8398
7/24/2022,Upton,Texas,48461,859,18,877
7/24/2022,Uvalde,Texas,48463,10967,145,11112
7/24/2022,Val Verde,Texas,48465,15026,304,15330
7/24/2022,Van Zandt,Texas,48467,10950,284,11234
7/24/2022,Victoria,Texas,48469,20440,412,20852
7/24/2022,Walker,Texas,48471,20279,214,20493
7/24/2022,Waller,Texas,48473,10446,108,10554
7/24/2022,Ward,Texas,48475,2959,45,3004
7/24/2022,Washington,Texas,48477,9814,149,9963
7/24/2022,Webb,Texas,48479,101417,1042,102459
7/24/2022,Wharton,Texas,48481,10069,218,10287
7/24/2022,Wheeler,Texas,48483,1233,23,1256
7/24/2022,Wichita,Texas,48485,35804,687,36491
7/24/2022,Wilbarger,Texas,48487,3680,88,3768
7/24/2022,Willacy,Texas,48489,7797,134,7931
7/24/2022,Williamson,Texas,48491,150027,937,150964
7/24/2022,Wilson,Texas,48493,11654,160,11814
7/24/2022,Winkler,Texas,48495,1920,34,1954
7/24/2022,Wise,Texas,48497,17758,273,18031
7/24/2022,Wood,Texas,48499,8439,289,8728
7/24/2022,Yoakum,Texas,48501,1348,42,1390
7/24/2022,Young,Texas,48503,4206,95,4301
7/24/2022,Zapata,Texas,48505,3946,55,4001
7/24/2022,Zavala,Texas,48507,4251,69,4320
7/24/2022,Beaver,Utah,49001,1677,16,1693
7/24/2022,Box Elder,Utah,49003,14865,125,14990
7/24/2022,Cache,Utah,49005,38989,111,39100
7/24/2022,Carbon,Utah,49007,5561,47,5608
7/24/2022,Daggett,Utah,49009,161,0,161
7/24/2022,Davis,Utah,49011,109166,415,109581
7/24/2022,Duchesne,Utah,49013,4672,27,4699
7/24/2022,Emery,Utah,49015,2638,28,2666
7/24/2022,Garfield,Utah,49017,982,16,998
7/24/2022,Grand,Utah,49019,2572,6,2578
7/24/2022,Iron,Utah,49021,15491,95,15586
7/24/2022,Juab,Utah,49023,3010,25,3035
7/24/2022,Kane,Utah,49025,1475,15,1490
7/24/2022,Millard,Utah,49027,3416,36,3452
7/24/2022,Morgan,Utah,49029,3043,15,3058
7/24/2022,Piute,Utah,49031,318,7,325
7/24/2022,Rich,Utah,49033,354,0,354
7/24/2022,Salt Lake,Utah,49035,376333,1682,378015
7/24/2022,San Juan,Utah,49037,4342,50,4392
7/24/2022,Sanpete,Utah,49039,8602,56,8658
7/24/2022,Sevier,Utah,49041,5627,30,5657
7/24/2022,Summit,Utah,49043,14874,27,14901
7/24/2022,Tooele,Utah,49045,23077,108,23185
7/24/2022,Uintah,Utah,49047,8697,74,8771
7/24/2022,Unknown,Utah,,4302,98,4400
7/24/2022,Utah,Utah,49049,213497,817,214314
7/24/2022,Wasatch,Utah,49051,11406,36,11442
7/24/2022,Washington,Utah,49053,47563,471,48034
7/24/2022,Wayne,Utah,49055,476,0,476
7/24/2022,Weber,Utah,49057,77498,451,77949
7/24/2022,Addison,Vermont,50001,6322,21,6343
7/24/2022,Bennington,Vermont,50003,10968,73,11041
7/24/2022,Caledonia,Vermont,50005,6170,30,6200
7/24/2022,Chittenden,Vermont,50007,36678,182,36860
7/24/2022,Essex,Vermont,50009,1360,3,1363
7/24/2022,Franklin,Vermont,50011,10679,68,10747
7/24/2022,Grand Isle,Vermont,50013,1188,6,1194
7/24/2022,Lamoille,Vermont,50015,4108,17,4125
7/24/2022,Orange,Vermont,50017,4681,14,4695
7/24/2022,Orleans,Vermont,50019,6915,38,6953
7/24/2022,Rutland,Vermont,50021,14747,78,14825
7/24/2022,Unknown,Vermont,,2126,4,2130
7/24/2022,Washington,Vermont,50023,13158,55,13213
7/24/2022,Windham,Vermont,50025,7678,40,7718
7/24/2022,Windsor,Vermont,50027,10486,60,10546
7/24/2022,Accomack,Virginia,51001,7681,108,7789
7/24/2022,Albemarle,Virginia,51003,21238,172,21410
7/24/2022,Alexandria city,Virginia,51510,38555,195,38750
7/24/2022,Alleghany,Virginia,51005,3691,101,3792
7/24/2022,Amelia,Virginia,51007,2926,59,2985
7/24/2022,Amherst,Virginia,51009,8062,93,8155
7/24/2022,Appomattox,Virginia,51011,4214,54,4268
7/24/2022,Arlington,Virginia,51013,56229,326,56555
7/24/2022,Augusta,Virginia,51015,20714,218,20932
7/24/2022,Bath,Virginia,51017,990,20,1010
7/24/2022,Bedford,Virginia,51019,18723,248,18971
7/24/2022,Bland,Virginia,51021,1943,24,1967
7/24/2022,Botetourt,Virginia,51023,8222,105,8327
7/24/2022,Bristol city,Virginia,51520,4829,83,4912
7/24/2022,Brunswick,Virginia,51025,3506,48,3554
7/24/2022,Buchanan,Virginia,51027,5129,126,5255
7/24/2022,Buckingham,Virginia,51029,4320,58,4378
7/24/2022,Buena Vista city,Virginia,51530,2172,46,2218
7/24/2022,Campbell,Virginia,51031,14433,222,14655
7/24/2022,Caroline,Virginia,51033,7673,89,7762
7/24/2022,Carroll,Virginia,51035,7396,150,7546
7/24/2022,Charles City,Virginia,51036,1286,29,1315
7/24/2022,Charlotte,Virginia,51037,2764,45,2809
7/24/2022,Charlottesville city,Virginia,51540,10862,79,10941
7/24/2022,Chesapeake city,Virginia,51550,55927,516,56443
7/24/2022,Chesterfield,Virginia,51041,84631,786,85417
7/24/2022,Clarke,Virginia,51043,2979,47,3026
7/24/2022,Colonial Heights city,Virginia,51570,5476,101,5577
7/24/2022,Covington city,Virginia,51580,1530,28,1558
7/24/2022,Craig,Virginia,51045,1180,21,1201
7/24/2022,Culpeper,Virginia,51047,12320,156,12476
7/24/2022,Cumberland,Virginia,51049,1516,27,1543
7/24/2022,Danville city,Virginia,51590,12255,286,12541
7/24/2022,Dickenson,Virginia,51051,3636,52,3688
7/24/2022,Dinwiddie,Virginia,51053,6043,95,6138
7/24/2022,Emporia city,Virginia,51595,1275,55,1330
7/24/2022,Essex,Virginia,51057,2422,35,2457
7/24/2022,Fairfax,Virginia,51059,219490,1497,220987
7/24/2022,Fairfax city,Virginia,51600,2263,45,2308
7/24/2022,Falls Church city,Virginia,51610,2827,17,2844
7/24/2022,Fauquier,Virginia,51061,14321,150,14471
7/24/2022,Floyd,Virginia,51063,2807,49,2856
7/24/2022,Fluvanna,Virginia,51065,5864,47,5911
7/24/2022,Franklin,Virginia,51067,11997,201,12198
7/24/2022,Franklin city,Virginia,51620,2441,53,2494
7/24/2022,Frederick,Virginia,51069,22695,256,22951
7/24/2022,Fredericksburg city,Virginia,51630,6041,41,6082
7/24/2022,Galax city,Virginia,51640,2859,79,2938
7/24/2022,Giles,Virginia,51071,4390,50,4440
7/24/2022,Gloucester,Virginia,51073,8047,106,8153
7/24/2022,Goochland,Virginia,51075,4649,54,4703
7/24/2022,Grayson,Virginia,51077,4354,83,4437
7/24/2022,Greene,Virginia,51079,4435,62,4497
7/24/2022,Greensville,Virginia,51081,3548,41,3589
7/24/2022,Halifax,Virginia,51083,8133,166,8299
7/24/2022,Hampton city,Virginia,51650,32147,338,32485
7/24/2022,Hanover,Virginia,51085,24642,296,24938
7/24/2022,Harrisonburg city,Virginia,51660,14262,166,14428
7/24/2022,Henrico,Virginia,51087,76224,967,77191
7/24/2022,Henry,Virginia,51089,13496,274,13770
7/24/2022,Highland,Virginia,51091,410,7,417
7/24/2022,Hopewell city,Virginia,51670,6652,119,6771
7/24/2022,Isle of Wight,Virginia,51093,8068,120,8188
7/24/2022,James City,Virginia,51095,17773,127,17900
7/24/2022,King and Queen,Virginia,51097,1232,12,1244
7/24/2022,King George,Virginia,51099,5777,45,5822
7/24/2022,King William,Virginia,51101,4076,46,4122
7/24/2022,Lancaster,Virginia,51103,2020,33,2053
7/24/2022,Lee,Virginia,51105,6538,95,6633
7/24/2022,Lexington city,Virginia,51678,2989,40,3029
7/24/2022,Loudoun,Virginia,51107,82931,397,83328
7/24/2022,Louisa,Virginia,51109,7479,85,7564
7/24/2022,Lunenburg,Virginia,51111,2794,39,2833
7/24/2022,Lynchburg city,Virginia,51680,21289,279,21568
7/24/2022,Madison,Virginia,51113,2651,43,2694
7/24/2022,Manassas city,Virginia,51683,10168,72,10240
7/24/2022,Manassas Park city,Virginia,51685,4210,27,4237
7/24/2022,Martinsville city,Virginia,51690,3718,124,3842
7/24/2022,Mathews,Virginia,51115,1657,27,1684
7/24/2022,Mecklenburg,Virginia,51117,6776,129,6905
7/24/2022,Middlesex,Virginia,51119,2065,48,2113
7/24/2022,Montgomery,Virginia,51121,21220,158,21378
7/24/2022,Nelson,Virginia,51125,2843,36,2879
7/24/2022,New Kent,Virginia,51127,5182,34,5216
7/24/2022,Newport News city,Virginia,51700,41663,413,42076
7/24/2022,Norfolk city,Virginia,51710,47185,484,47669
7/24/2022,Northampton,Virginia,51131,2435,67,2502
7/24/2022,Northumberland,Virginia,51133,2359,43,2402
7/24/2022,Norton city,Virginia,51720,1445,22,1467
7/24/2022,Nottoway,Virginia,51135,4683,94,4777
7/24/2022,Orange,Virginia,51137,7609,91,7700
7/24/2022,Page,Virginia,51139,5946,123,6069
7/24/2022,Patrick,Virginia,51141,4000,97,4097
7/24/2022,Petersburg city,Virginia,51730,8932,141,9073
7/24/2022,Pittsylvania,Virginia,51143,15589,211,15800
7/24/2022,Poquoson city,Virginia,51735,2585,30,2615
7/24/2022,Portsmouth city,Virginia,51740,23097,341,23438
7/24/2022,Powhatan,Virginia,51145,5648,62,5710
7/24/2022,Prince Edward,Virginia,51147,5536,77,5613
7/24/2022,Prince George,Virginia,51149,9756,80,9836
7/24/2022,Prince William,Virginia,51153,109166,758,109924
7/24/2022,Pulaski,Virginia,51155,8039,141,8180
7/24/2022,Radford city,Virginia,51750,5422,54,5476
7/24/2022,Rappahannock,Virginia,51157,1127,10,1137
7/24/2022,Richmond,Virginia,51159,2729,25,2754
7/24/2022,Richmond city,Virginia,51760,52044,520,52564
7/24/2022,Roanoke,Virginia,51161,23750,288,24038
7/24/2022,Roanoke city,Virginia,51770,23754,381,24135
7/24/2022,Rockbridge,Virginia,51163,3687,80,3767
7/24/2022,Rockingham,Virginia,51165,15578,236,15814
7/24/2022,Russell,Virginia,51167,7364,116,7480
7/24/2022,Salem city,Virginia,51775,6228,99,6327
7/24/2022,Scott,Virginia,51169,6187,113,6300
7/24/2022,Shenandoah,Virginia,51171,11639,233,11872
7/24/2022,Smyth,Virginia,51173,9582,175,9757
7/24/2022,Southampton,Virginia,51175,3806,96,3902
7/24/2022,Spotsylvania,Virginia,51177,30541,306,30847
7/24/2022,Stafford,Virginia,51179,35258,179,35437
7/24/2022,Staunton city,Virginia,51790,6283,118,6401
7/24/2022,Suffolk city,Virginia,51800,21116,310,21426
7/24/2022,Surry,Virginia,51181,1200,20,1220
7/24/2022,Sussex,Virginia,51183,2618,43,2661
7/24/2022,Tazewell,Virginia,51185,11159,178,11337
7/24/2022,Virginia Beach city,Virginia,51810,100922,855,101777
7/24/2022,Warren,Virginia,51187,9454,160,9614
7/24/2022,Washington,Virginia,51191,15047,219,15266
7/24/2022,Waynesboro city,Virginia,51820,6477,68,6545
7/24/2022,Westmoreland,Virginia,51193,3521,55,3576
7/24/2022,Williamsburg city,Virginia,51830,1984,23,2007
7/24/2022,Winchester city,Virginia,51840,6935,81,7016
7/24/2022,Wise,Virginia,51195,11385,205,11590
7/24/2022,Wythe,Virginia,51197,8181,150,8331
7/24/2022,York,Virginia,51199,11517,113,11630
7/24/2022,St. Croix,Virgin Islands,78010,10902,52,10954
7/24/2022,St. John,Virgin Islands,78020,975,5,980
7/24/2022,St. Thomas,Virgin Islands,78030,9663,63,9726
7/24/2022,Adams,Washington,53001,5244,39,5283
7/24/2022,Asotin,Washington,53003,4861,71,4932
7/24/2022,Benton,Washington,53005,56679,495,57174
7/24/2022,Chelan,Washington,53007,21994,171,22165
7/24/2022,Clallam,Washington,53009,13848,159,14007
7/24/2022,Clark,Washington,53011,100854,865,101719
7/24/2022,Columbia,Washington,53013,659,16,675
7/24/2022,Cowlitz,Washington,53015,25077,367,25444
7/24/2022,Douglas,Washington,53017,12131,74,12205
7/24/2022,Ferry,Washington,53019,1560,29,1589
7/24/2022,Franklin,Washington,53021,34242,216,34458
7/24/2022,Garfield,Washington,53023,423,7,430
7/24/2022,Grant,Washington,53025,29101,263,29364
7/24/2022,Grays Harbor,Washington,53027,18541,210,18751
7/24/2022,Island,Washington,53029,11980,90,12070
7/24/2022,Jefferson,Washington,53031,3924,30,3954
7/24/2022,King,Washington,53033,486139,2975,489114
7/24/2022,Kitsap,Washington,53035,46366,369,46735
7/24/2022,Kittitas,Washington,53037,9510,76,9586
7/24/2022,Klickitat,Washington,53039,3948,51,3999
7/24/2022,Lewis,Washington,53041,19208,268,19476
7/24/2022,Lincoln,Washington,53043,2423,29,2452
7/24/2022,Mason,Washington,53045,13842,150,13992
7/24/2022,Okanogan,Washington,53047,9302,129,9431
7/24/2022,Pacific,Washington,53049,4253,63,4316
7/24/2022,Pend Oreille,Washington,53051,2652,37,2689
7/24/2022,Pierce,Washington,53053,219715,1459,221174
7/24/2022,San Juan,Washington,53055,1724,2,1726
7/24/2022,Skagit,Washington,53057,25246,213,25459
7/24/2022,Skamania,Washington,53059,1657,12,1669
7/24/2022,Snohomish,Washington,53061,181125,1214,182339
7/24/2022,Spokane,Washington,53063,137546,1457,139003
7/24/2022,Stevens,Washington,53065,8867,154,9021
7/24/2022,Thurston,Washington,53067,56043,440,56483
7/24/2022,Wahkiakum,Washington,53069,574,8,582
7/24/2022,Walla Walla,Washington,53071,17774,156,17930
7/24/2022,Whatcom,Washington,53073,44362,313,44675
7/24/2022,Whitman,Washington,53075,9112,92,9204
7/24/2022,Yakima,Washington,53077,78315,803,79118
7/24/2022,Barbour,West Virginia,54001,5212,74,5286
7/24/2022,Berkeley,West Virginia,54003,38897,311,39208
7/24/2022,Boone,West Virginia,54005,7280,81,7361
7/24/2022,Braxton,West Virginia,54007,4371,45,4416
7/24/2022,Brooke,West Virginia,54009,5452,104,5556
7/24/2022,Cabell,West Virginia,54011,30037,390,30427
7/24/2022,Calhoun,West Virginia,54013,2022,15,2037
7/24/2022,Clay,West Virginia,54015,2472,47,2519
7/24/2022,Doddridge,West Virginia,54017,2257,18,2275
7/24/2022,Fayette,West Virginia,54019,14376,212,14588
7/24/2022,Gilmer,West Virginia,54021,2263,19,2282
7/24/2022,Grant,West Virginia,54023,4024,56,4080
7/24/2022,Greenbrier,West Virginia,54025,10708,165,10873
7/24/2022,Hampshire,West Virginia,54027,6336,74,6410
7/24/2022,Hancock,West Virginia,54029,7317,143,7460
7/24/2022,Hardy,West Virginia,54031,4529,49,4578
7/24/2022,Harrison,West Virginia,54033,22201,259,22460
7/24/2022,Jackson,West Virginia,54035,7483,136,7619
7/24/2022,Jefferson,West Virginia,54037,15817,137,15954
7/24/2022,Kanawha,West Virginia,54039,51900,754,52654
7/24/2022,Lewis,West Virginia,54041,5984,90,6074
7/24/2022,Lincoln,West Virginia,54043,6022,84,6106
7/24/2022,Logan,West Virginia,54045,10688,190,10878
7/24/2022,Marion,West Virginia,54049,16925,182,17107
7/24/2022,Marshall,West Virginia,54051,9817,157,9974
7/24/2022,Mason,West Virginia,54053,7447,98,7545
7/24/2022,McDowell,West Virginia,54047,6233,77,6310
7/24/2022,Mercer,West Virginia,54055,18976,270,19246
7/24/2022,Mineral,West Virginia,54057,8656,161,8817
7/24/2022,Mingo,West Virginia,54059,8479,125,8604
7/24/2022,Monongalia,West Virginia,54061,27415,198,27613
7/24/2022,Monroe,West Virginia,54063,4658,46,4704
7/24/2022,Morgan,West Virginia,54065,4510,70,4580
7/24/2022,Nicholas,West Virginia,54067,8078,100,8178
7/24/2022,Ohio,West Virginia,54069,12224,181,12405
7/24/2022,Pendleton,West Virginia,54071,2075,22,2097
7/24/2022,Pleasants,West Virginia,54073,2208,38,2246
7/24/2022,Pocahontas,West Virginia,54075,2180,32,2212
7/24/2022,Preston,West Virginia,54077,9853,140,9993
7/24/2022,Putnam,West Virginia,54079,18307,188,18495
7/24/2022,Raleigh,West Virginia,54081,25455,369,25824
7/24/2022,Randolph,West Virginia,54083,10245,92,10337
7/24/2022,Ritchie,West Virginia,54085,2618,31,2649
7/24/2022,Roane,West Virginia,54087,3610,39,3649
7/24/2022,Summers,West Virginia,54089,3084,56,3140
7/24/2022,Taylor,West Virginia,54091,5021,73,5094
7/24/2022,Tucker,West Virginia,54093,2127,38,2165
7/24/2022,Tyler,West Virginia,54095,2346,32,2378
7/24/2022,Upshur,West Virginia,54097,7619,97,7716
7/24/2022,Wayne,West Virginia,54099,10533,130,10663
7/24/2022,Webster,West Virginia,54101,2483,34,2517
7/24/2022,Wetzel,West Virginia,54103,4764,87,4851
7/24/2022,Wirt,West Virginia,54105,1532,25,1557
7/24/2022,Wood,West Virginia,54107,23931,355,24286
7/24/2022,Wyoming,West Virginia,54109,7720,125,7845
7/24/2022,Adams,Wisconsin,55001,5087,64,5151
7/24/2022,Ashland,Wisconsin,55003,3707,39,3746
7/24/2022,Barron,Wisconsin,55005,14400,147,14547
7/24/2022,Bayfield,Wisconsin,55007,3862,42,3904
7/24/2022,Brown,Wisconsin,55009,91161,571,91732
7/24/2022,Buffalo,Wisconsin,55011,3790,12,3802
7/24/2022,Burnett,Wisconsin,55013,4416,46,4462
7/24/2022,Calumet,Wisconsin,55015,15436,125,15561
7/24/2022,Chippewa,Wisconsin,55017,19968,193,20161
7/24/2022,Clark,Wisconsin,55019,8072,122,8194
7/24/2022,Columbia,Wisconsin,55021,17164,133,17297
7/24/2022,Crawford,Wisconsin,55023,4574,29,4603
7/24/2022,Dane,Wisconsin,55025,154088,539,154627
7/24/2022,Dodge,Wisconsin,55027,28857,343,29200
7/24/2022,Door,Wisconsin,55029,7657,73,7730
7/24/2022,Douglas,Wisconsin,55031,12893,80,12973
7/24/2022,Dunn,Wisconsin,55033,14262,76,14338
7/24/2022,Eau Claire,Wisconsin,55035,33034,194,33228
7/24/2022,Florence,Wisconsin,55037,1154,17,1171
7/24/2022,Fond du Lac,Wisconsin,55039,34378,286,34664
7/24/2022,Forest,Wisconsin,55041,2920,52,2972
7/24/2022,Grant,Wisconsin,55043,13826,149,13975
7/24/2022,Green,Wisconsin,55045,10162,55,10217
7/24/2022,Green Lake,Wisconsin,55047,5594,65,5659
7/24/2022,Iowa,Wisconsin,55049,5962,30,5992
7/24/2022,Iron,Wisconsin,55051,1584,48,1632
7/24/2022,Jackson,Wisconsin,55053,6064,43,6107
7/24/2022,Jefferson,Wisconsin,55055,23535,247,23782
7/24/2022,Juneau,Wisconsin,55057,8323,70,8393
7/24/2022,Kenosha,Wisconsin,55059,48834,649,49483
7/24/2022,Kewaunee,Wisconsin,55061,6197,60,6257
7/24/2022,La Crosse,Wisconsin,55063,38662,190,38852
7/24/2022,Lafayette,Wisconsin,55065,3957,29,3986
7/24/2022,Langlade,Wisconsin,55067,5734,92,5826
7/24/2022,Lincoln,Wisconsin,55069,7818,152,7970
7/24/2022,Manitowoc,Wisconsin,55071,22122,192,22314
7/24/2022,Marathon,Wisconsin,55073,43371,507,43878
7/24/2022,Marinette,Wisconsin,55075,12475,132,12607
7/24/2022,Marquette,Wisconsin,55077,4148,61,4209
7/24/2022,Menominee,Wisconsin,55078,2061,15,2076
7/24/2022,Milwaukee,Wisconsin,55079,299584,2337,301921
7/24/2022,Monroe,Wisconsin,55081,13028,99,13127
7/24/2022,Oconto,Wisconsin,55083,12017,125,12142
7/24/2022,Oneida,Wisconsin,55085,9437,139,9576
7/24/2022,Outagamie,Wisconsin,55087,58342,419,58761
7/24/2022,Ozaukee,Wisconsin,55089,24973,192,25165
7/24/2022,Pepin,Wisconsin,55091,2088,18,2106
7/24/2022,Pierce,Wisconsin,55093,12372,75,12447
7/24/2022,Polk,Wisconsin,55095,13367,121,13488
7/24/2022,Portage,Wisconsin,55097,19927,162,20089
7/24/2022,Price,Wisconsin,55099,3506,34,3540
7/24/2022,Racine,Wisconsin,55101,62058,707,62765
7/24/2022,Richland,Wisconsin,55103,4309,51,4360
7/24/2022,Rock,Wisconsin,55105,47710,403,48113
7/24/2022,Rusk,Wisconsin,55107,3685,58,3743
7/24/2022,Sauk,Wisconsin,55111,17955,139,18094
7/24/2022,Sawyer,Wisconsin,55113,5098,63,5161
7/24/2022,Shawano,Wisconsin,55115,12523,155,12678
7/24/2022,Sheboygan,Wisconsin,55117,35377,333,35710
7/24/2022,St. Croix,Wisconsin,55109,27325,154,27479
7/24/2022,Taylor,Wisconsin,55119,5098,73,5171
7/24/2022,Trempealeau,Wisconsin,55121,8941,67,9008
7/24/2022,Vernon,Wisconsin,55123,6709,103,6812
7/24/2022,Vilas,Wisconsin,55125,5738,91,5829
7/24/2022,Walworth,Wisconsin,55127,29050,288,29338
7/24/2022,Washburn,Wisconsin,55129,4386,47,4433
7/24/2022,Washington,Wisconsin,55131,41680,348,42028
7/24/2022,Waukesha,Wisconsin,55133,124878,1132,126010
7/24/2022,Waupaca,Wisconsin,55135,14553,256,14809
7/24/2022,Waushara,Wisconsin,55137,6842,87,6929
7/24/2022,Winnebago,Wisconsin,55139,56365,396,56761
7/24/2022,Wood,Wisconsin,55141,23408,239,23647
7/24/2022,Albany,Wyoming,56001,10702,51,10753
7/24/2022,Big Horn,Wyoming,56003,2782,63,2845
7/24/2022,Campbell,Wyoming,56005,12713,150,12863
7/24/2022,Carbon,Wyoming,56007,4683,52,4735
7/24/2022,Converse,Wyoming,56009,3298,55,3353
7/24/2022,Crook,Wyoming,56011,1425,29,1454
7/24/2022,Fremont,Wyoming,56013,15036,195,15231
7/24/2022,Goshen,Wyoming,56015,4188,57,4245
7/24/2022,Hot Springs,Wyoming,56017,1272,18,1290
7/24/2022,Johnson,Wyoming,56019,2027,20,2047
7/24/2022,Laramie,Wyoming,56021,28547,295,28842
7/24/2022,Lincoln,Wyoming,56023,4462,32,4494
7/24/2022,Natrona,Wyoming,56025,23565,280,23845
7/24/2022,Niobrara,Wyoming,56027,732,10,742
7/24/2022,Park,Wyoming,56029,7209,146,7355
7/24/2022,Platte,Wyoming,56031,2071,42,2113
7/24/2022,Sheridan,Wyoming,56033,8812,82,8894
7/24/2022,Sublette,Wyoming,56035,2063,27,2090
7/24/2022,Sweetwater,Wyoming,56037,11747,127,11874
7/24/2022,Teton,Wyoming,56039,11148,16,11164
7/24/2022,Uinta,Wyoming,56041,5926,39,5965
7/24/2022,Washakie,Wyoming,56043,2544,44,2588
7/24/2022,Weston,Wyoming,56045,1726,20,1746
8/7/2022,Le Flore,Oklahoma,40079,13574,108,13682
8/7/2022,Latimer,Oklahoma,40077,2421,35,2456
8/7/2022,Kiowa,Oklahoma,40075,2075,55,2130
8/7/2022,Kingfisher,Oklahoma,40073,4377,71,4448
8/7/2022,Kay,Oklahoma,40071,13308,219,13527
8/7/2022,Johnston,Oklahoma,40069,3277,56,3333
8/7/2022,Mercer,Ohio,39107,10182,144,10326
8/7/2022,Miami,Ohio,39109,28150,487,28637
8/7/2022,Monroe,Ohio,39111,3775,81,3856
8/7/2022,Montgomery,Ohio,39113,141426,2043,143469
8/7/2022,Morgan,Ohio,39115,3615,61,3676
8/7/2022,Morrow,Ohio,39117,8462,105,8567
8/7/2022,Muskingum,Ohio,39119,27947,296,28243
8/7/2022,Noble,Ohio,39121,3497,59,3556
8/7/2022,Ottawa,Ohio,39123,9429,142,9571
8/7/2022,Paulding,Ohio,39125,4961,74,5035
8/7/2022,Perry,Ohio,39127,9103,129,9232
8/7/2022,Jefferson,Oklahoma,40067,1403,26,1429
8/7/2022,Jackson,Oklahoma,40065,7099,108,7207
8/7/2022,Hughes,Oklahoma,40063,2810,63,2873
8/7/2022,Haskell,Oklahoma,40061,2989,42,3031
8/7/2022,Harper,Oklahoma,40059,762,12,774
8/7/2022,Pickaway,Ohio,39129,18934,233,19167
8/7/2022,Pike,Ohio,39131,8397,123,8520
8/7/2022,Portage,Ohio,39133,38226,451,38677
8/7/2022,Preble,Ohio,39135,10252,200,10452
8/7/2022,Putnam,Ohio,39137,8861,159,9020
8/7/2022,Richland,Ohio,39139,34575,517,35092
8/7/2022,Ross,Ohio,39141,21469,307,21776
8/7/2022,Sandusky,Ohio,39143,15143,241,15384
8/7/2022,Harmon,Oklahoma,40057,594,12,606
8/7/2022,Scioto,Ohio,39145,23441,262,23703
8/7/2022,Seneca,Ohio,39147,13684,234,13918
8/7/2022,Greer,Oklahoma,40055,1366,38,1404
8/7/2022,Grant,Oklahoma,40053,1099,16,1115
8/7/2022,Grady,Oklahoma,40051,14771,250,15021
8/7/2022,Garvin,Oklahoma,40049,7555,149,7704
8/7/2022,Garfield,Oklahoma,40047,16015,298,16313
8/7/2022,Ellis,Oklahoma,40045,880,11,891
8/7/2022,Dewey,Oklahoma,40043,1117,34,1151
8/7/2022,Delaware,Oklahoma,40041,11989,206,12195
8/7/2022,Shelby,Ohio,39149,11892,191,12083
8/7/2022,Stark,Ohio,39151,86966,1738,88704
8/7/2022,Custer,Oklahoma,40039,8557,172,8729
8/7/2022,Creek,Oklahoma,40037,19596,339,19935
8/7/2022,Craig,Oklahoma,40035,5149,55,5204
8/7/2022,Cotton,Oklahoma,40033,1540,32,1572
8/7/2022,Summit,Ohio,39153,125846,1741,127587
8/7/2022,Trumbull,Ohio,39155,46057,954,47011
8/7/2022,Tuscarawas,Ohio,39157,22350,513,22863
8/7/2022,Union,Ohio,39159,17514,102,17616
8/7/2022,Unknown,Ohio,,0,5,5
8/7/2022,Fulton,Georgia,13121,250345,2434,252779
8/7/2022,Franklin,Georgia,13119,5689,104,5793
8/7/2022,Gilmer,Georgia,13123,7516,183,7699
8/7/2022,Forsyth,Georgia,13117,61883,414,62297
8/7/2022,Floyd,Georgia,13115,29426,533,29959
8/7/2022,Glascock,Georgia,13125,643,26,669
8/7/2022,Glynn,Georgia,13127,25310,413,25723
8/7/2022,Fayette,Georgia,13113,26088,336,26424
8/7/2022,Fannin,Georgia,13111,5474,166,5640
8/7/2022,Gordon,Georgia,13129,18121,274,18395
8/7/2022,Grady,Georgia,13131,6396,113,6509
8/7/2022,Greene,Georgia,13133,4295,89,4384
8/7/2022,Gwinnett,Georgia,13135,232231,1940,234171
8/7/2022,Evans,Georgia,13109,2576,64,2640
8/7/2022,Habersham,Georgia,13137,10776,270,11046
8/7/2022,Emanuel,Georgia,13107,6289,162,6451
8/7/2022,Elbert,Georgia,13105,4774,113,4887
8/7/2022,Effingham,Georgia,13103,14609,201,14810
8/7/2022,Echols,Georgia,13101,993,12,1005
8/7/2022,Early,Georgia,13099,2986,65,3051
8/7/2022,Douglas,Georgia,13097,38884,418,39302
8/7/2022,Hall,Georgia,13139,58688,863,59551
8/7/2022,Hancock,Georgia,13141,1738,90,1828
8/7/2022,Haralson,Georgia,13143,5825,178,6003
8/7/2022,Dougherty,Georgia,13095,22024,512,22536
8/7/2022,Dooly,Georgia,13093,2576,70,2646
8/7/2022,DeKalb,Georgia,13089,173812,1801,175613
8/7/2022,Dodge,Georgia,13091,5521,157,5678
8/7/2022,Harris,Georgia,13145,6536,118,6654
8/7/2022,Decatur,Georgia,13087,7926,135,8061
8/7/2022,Dawson,Georgia,13085,7615,101,7716
8/7/2022,Dade,Georgia,13083,3668,34,3702
8/7/2022,Crisp,Georgia,13081,5136,137,5273
8/7/2022,Crawford,Georgia,13079,1959,59,2018
8/7/2022,Coweta,Georgia,13077,36933,500,37433
8/7/2022,Hart,Georgia,13147,5139,105,5244
8/7/2022,Cook,Georgia,13075,5285,77,5362
8/7/2022,Columbia,Georgia,13073,39393,399,39792
8/7/2022,Colquitt,Georgia,13071,12654,253,12907
8/7/2022,Coffee,Georgia,13069,11199,286,11485
8/7/2022,Cobb,Georgia,13067,196950,1912,198862
8/7/2022,Clinch,Georgia,13065,2261,43,2304
8/7/2022,Heard,Georgia,13149,2341,57,2398
8/7/2022,Clayton,Georgia,13063,70930,1017,71947
8/7/2022,Henry,Georgia,13151,64527,699,65226
8/7/2022,Houston,Georgia,13153,44495,510,45005
8/7/2022,Irwin,Georgia,13155,2058,51,2109
8/7/2022,Clay,Georgia,13061,566,6,572
8/7/2022,Clarke,Georgia,13059,32217,244,32461
8/7/2022,Cherokee,Georgia,13057,69395,653,70048
8/7/2022,Chattooga,Georgia,13055,7161,137,7298
8/7/2022,Chattahoochee,Georgia,13053,7609,22,7631
8/7/2022,Chatham,Georgia,13051,71758,920,72678
8/7/2022,Charlton,Georgia,13049,3226,64,3290
8/7/2022,Jackson,Georgia,13157,22599,294,22893
8/7/2022,Jasper,Georgia,13159,3412,75,3487
8/7/2022,Jeff Davis,Georgia,13161,4092,74,4166
8/7/2022,Jefferson,Georgia,13163,3900,114,4014
8/7/2022,Jenkins,Georgia,13165,1626,68,1694
8/7/2022,Johnson,Georgia,13167,2417,75,2492
8/7/2022,Catoosa,Georgia,13047,15813,182,15995
8/7/2022,Carroll,Georgia,13045,25740,470,26210
8/7/2022,Candler,Georgia,13043,2381,103,2484
8/7/2022,Camden,Georgia,13039,12628,126,12754
8/7/2022,Calhoun,Georgia,13037,1458,24,1482
8/7/2022,Butts,Georgia,13035,7016,165,7181
8/7/2022,Jones,Georgia,13169,5524,110,5634
8/7/2022,Burke,Georgia,13033,5740,114,5854
8/7/2022,Lamar,Georgia,13171,5240,116,5356
8/7/2022,Lanier,Georgia,13173,2459,26,2485
8/7/2022,Laurens,Georgia,13175,14891,310,15201
8/7/2022,Bulloch,Georgia,13031,16495,269,16764
8/7/2022,Bryan,Georgia,13029,10011,97,10108
8/7/2022,Brooks,Georgia,13027,3700,87,3787
8/7/2022,Lee,Georgia,13177,8065,106,8171
8/7/2022,Brantley,Georgia,13025,4389,111,4500
8/7/2022,Bleckley,Georgia,13023,3573,101,3674
8/7/2022,Bibb,Georgia,13021,41484,802,42286
8/7/2022,Liberty,Georgia,13179,13704,153,13857
8/7/2022,Berrien,Georgia,13019,5302,86,5388
8/7/2022,Lincoln,Georgia,13181,1691,35,1726
8/7/2022,Ben Hill,Georgia,13017,4616,123,4739
8/7/2022,Bartow,Georgia,13015,31751,455,32206
8/7/2022,Barrow,Georgia,13013,23596,264,23860
8/7/2022,Banks,Georgia,13011,4232,98,4330
8/7/2022,Baldwin,Georgia,13009,10327,245,10572
8/7/2022,Long,Georgia,13183,3050,35,3085
8/7/2022,Lowndes,Georgia,13185,33982,401,34383
8/7/2022,Baker,Georgia,13007,589,15,604
8/7/2022,Bacon,Georgia,13005,3903,79,3982
8/7/2022,Lumpkin,Georgia,13187,7920,134,8054
8/7/2022,Atkinson,Georgia,13003,2318,52,2370
8/7/2022,Appling,Georgia,13001,4990,132,5122
8/7/2022,Washington,Florida,12133,7116,114,7230
8/7/2022,Walton,Florida,12131,18060,219,18279
8/7/2022,Wakulla,Florida,12129,11027,131,11158
8/7/2022,Volusia,Florida,12127,135156,2082,137238
8/7/2022,Unknown,Florida,,65737,482,66219
8/7/2022,Union,Florida,12125,4630,119,4749
8/7/2022,Taylor,Florida,12123,7532,104,7636
8/7/2022,Suwannee,Florida,12121,14075,326,14401
8/7/2022,Sumter,Florida,12119,25974,615,26589
8/7/2022,St. Lucie,Florida,12111,85751,1278,87029
8/7/2022,Macon,Georgia,13193,2373,52,2425
8/7/2022,St. Johns,Florida,12109,70910,597,71507
8/7/2022,Seminole,Florida,12117,119796,1145,120941
8/7/2022,Sarasota,Florida,12115,106942,1737,108679
8/7/2022,Santa Rosa,Florida,12113,53915,642,54557
8/7/2022,Putnam,Florida,12107,19373,431,19804
8/7/2022,Polk,Florida,12105,231830,3109,234939
8/7/2022,Madison,Georgia,13195,7359,114,7473
8/7/2022,Pinellas,Florida,12103,246173,3562,249735
8/7/2022,Pasco,Florida,12101,142468,2008,144476
8/7/2022,Palm Beach,Florida,12099,428892,5349,434241
8/7/2022,Osceola,Florida,12097,130691,1187,131878
8/7/2022,Orange,Florida,12095,434463,2961,437424
8/7/2022,Okeechobee,Florida,12093,11500,187,11687
8/7/2022,Marion,Georgia,13197,1677,52,1729
8/7/2022,Okaloosa,Florida,12091,56692,709,57401
8/7/2022,McDuffie,Georgia,13189,5524,104,5628
8/7/2022,McIntosh,Georgia,13191,2681,38,2719
8/7/2022,Meriwether,Georgia,13199,4942,148,5090
8/7/2022,Miller,Georgia,13201,1875,31,1906
8/7/2022,Mitchell,Georgia,13205,5765,119,5884
8/7/2022,Monroe,Georgia,13207,6472,178,6650
8/7/2022,Nassau,Florida,12089,24704,311,25015
8/7/2022,Monroe,Florida,12087,20698,125,20823
8/7/2022,Miami-Dade,Florida,12086,1394774,11384,1406158
8/7/2022,Montgomery,Georgia,13209,2171,53,2224
8/7/2022,Martin,Florida,12085,35451,652,36103
8/7/2022,Marion,Florida,12083,93985,2204,96189
8/7/2022,Manatee,Florida,12081,110423,1528,111951
8/7/2022,Madison,Florida,12079,6465,98,6563
8/7/2022,Liberty,Florida,12077,2708,30,2738
8/7/2022,Levy,Florida,12075,11405,174,11579
8/7/2022,Morgan,Georgia,13211,4979,70,5049
8/7/2022,Murray,Georgia,13213,12337,194,12531
8/7/2022,Muscogee,Georgia,13215,41778,847,42625
8/7/2022,Newton,Georgia,13217,27190,468,27658
8/7/2022,Leon,Florida,12073,100196,692,100888
8/7/2022,Lee,Florida,12071,215977,2249,218226
8/7/2022,Lake,Florida,12069,97701,1585,99286
8/7/2022,Lafayette,Florida,12067,2941,61,3002
8/7/2022,Jefferson,Florida,12065,4467,61,4528
8/7/2022,Jackson,Florida,12063,16247,287,16534
8/7/2022,Oconee,Georgia,13219,9422,108,9530
8/7/2022,Indian River,Florida,12061,38215,691,38906
8/7/2022,Holmes,Florida,12059,5866,93,5959
8/7/2022,Oglethorpe,Georgia,13221,3458,59,3517
8/7/2022,Paulding,Georgia,13223,42091,440,42531
8/7/2022,Hillsborough,Florida,12057,432912,3978,436890
8/7/2022,Highlands,Florida,12055,27334,714,28048
8/7/2022,Hernando,Florida,12053,48340,1150,49490
8/7/2022,Hendry,Florida,12051,12713,162,12875
8/7/2022,Peach,Georgia,13225,7033,136,7169
8/7/2022,Pickens,Georgia,13227,9109,173,9282
8/7/2022,Hardee,Florida,12049,9418,126,9544
8/7/2022,Hamilton,Florida,12047,4138,56,4194
8/7/2022,Pierce,Georgia,13229,6000,136,6136
8/7/2022,Gulf,Florida,12045,4654,82,4736
8/7/2022,Glades,Florida,12043,2153,36,2189
8/7/2022,Gilchrist,Florida,12041,5082,102,5184
8/7/2022,Gadsden,Florida,12039,15473,212,15685
8/7/2022,Franklin,Florida,12037,3277,54,3331
8/7/2022,Flagler,Florida,12035,25800,381,26181
8/7/2022,Pike,Georgia,13231,5865,99,5964
8/7/2022,Escambia,Florida,12033,86353,1365,87718
8/7/2022,Polk,Georgia,13233,12766,200,12966
8/7/2022,Pulaski,Georgia,13235,2343,78,2421
8/7/2022,Putnam,Georgia,13237,4833,107,4940
8/7/2022,Quitman,Georgia,13239,471,4,475
8/7/2022,Duval,Florida,12031,286522,3525,290047
8/7/2022,Dixie,Florida,12029,4470,75,4545
8/7/2022,DeSoto,Florida,12027,10331,154,10485
8/7/2022,Columbia,Florida,12023,23080,418,23498
8/7/2022,Collier,Florida,12021,94091,1054,95145
8/7/2022,Clay,Florida,12019,60330,885,61215
8/7/2022,Citrus,Florida,12017,34434,1020,35454
8/7/2022,Charlotte,Florida,12015,42214,855,43069
8/7/2022,Rabun,Georgia,13241,3883,101,3984
8/7/2022,Randolph,Georgia,13243,1628,48,1676
8/7/2022,Calhoun,Florida,12013,4437,101,4538
8/7/2022,Broward,Florida,12011,702243,6140,708383
8/7/2022,Brevard,Florida,12009,156915,2235,159150
8/7/2022,Bradford,Florida,12007,8281,160,8441
8/7/2022,Richmond,Georgia,13245,55155,905,56060
8/7/2022,Bay,Florida,12005,50409,840,51249
8/7/2022,Baker,Florida,12003,9390,143,9533
8/7/2022,Alachua,Florida,12001,79514,705,80219
8/7/2022,District of Columbia,District of Columbia,11001,163429,1369,164798
8/7/2022,Unknown,Delaware,,1045,0,1045
8/7/2022,Sussex,Delaware,10005,69171,885,70056
8/7/2022,Rockdale,Georgia,13247,21064,331,21395
8/7/2022,New Castle,Delaware,10003,168554,1474,170028
8/7/2022,Kent,Delaware,10001,57420,667,58087
8/7/2022,Windham,Connecticut,9015,28525,311,28836
8/7/2022,Unknown,Connecticut,,2753,1,2754
8/7/2022,Tolland,Connecticut,9013,24419,289,24708
8/7/2022,New London,Connecticut,9011,64451,694,65145
8/7/2022,Schley,Georgia,13249,1284,11,1295
8/7/2022,Screven,Georgia,13251,2892,71,2963
8/7/2022,Seminole,Georgia,13253,2313,31,2344
8/7/2022,New Haven,Connecticut,9009,225846,2896,228742
8/7/2022,Middlesex,Connecticut,9007,34028,490,34518
8/7/2022,Litchfield,Connecticut,9005,36494,470,36964
8/7/2022,Hartford,Connecticut,9003,207055,3220,210275
8/7/2022,Fairfield,Connecticut,9001,235131,2767,237898
8/7/2022,Spalding,Georgia,13255,17482,427,17909
8/7/2022,Stephens,Georgia,13257,6700,168,6868
8/7/2022,Stewart,Georgia,13259,2867,35,2902
8/7/2022,Yuma,Colorado,8125,2112,25,2137
8/7/2022,Weld,Colorado,8123,96920,719,97639
8/7/2022,Washington,Colorado,8121,1116,29,1145
8/7/2022,Sumter,Georgia,13261,7668,173,7841
8/7/2022,Teller,Colorado,8119,5484,59,5543
8/7/2022,Talbot,Georgia,13263,1251,33,1284
8/7/2022,Taliaferro,Georgia,13265,297,4,301
8/7/2022,Tattnall,Georgia,13267,5396,135,5531
8/7/2022,Taylor,Georgia,13269,2151,54,2205
8/7/2022,Telfair,Georgia,13271,3199,88,3287
8/7/2022,Summit,Colorado,8117,11320,14,11334
8/7/2022,Sedgwick,Colorado,8115,510,10,520
8/7/2022,San Miguel,Colorado,8113,2559,8,2567
8/7/2022,San Juan,Colorado,8111,294,0,294
8/7/2022,Terrell,Georgia,13273,2274,68,2342
8/7/2022,Thomas,Georgia,13275,13113,215,13328
8/7/2022,Saguache,Colorado,8109,1363,12,1375
8/7/2022,Routt,Colorado,8107,7311,29,7340
8/7/2022,Rio Grande,Colorado,8105,3243,46,3289
8/7/2022,Rio Blanco,Colorado,8103,1955,13,1968
8/7/2022,Tift,Georgia,13277,12574,225,12799
8/7/2022,Toombs,Georgia,13279,7477,206,7683
8/7/2022,Pueblo,Colorado,8101,54496,827,55323
8/7/2022,Prowers,Colorado,8099,2813,51,2864
8/7/2022,Pitkin,Colorado,8097,7620,8,7628
8/7/2022,Phillips,Colorado,8095,957,19,976
8/7/2022,Park,Colorado,8093,3241,22,3263
8/7/2022,Ouray,Colorado,8091,1030,6,1036
8/7/2022,Otero,Colorado,8089,4779,132,4911
8/7/2022,Morgan,Colorado,8087,6292,138,6430
8/7/2022,Towns,Georgia,13281,2616,118,2734
8/7/2022,Montrose,Colorado,8085,10344,170,10514
8/7/2022,Treutlen,Georgia,13283,1726,64,1790
8/7/2022,Montezuma,Colorado,8083,6753,83,6836
8/7/2022,Moffat,Colorado,8081,3336,53,3389
8/7/2022,Mineral,Colorado,8079,282,3,285
8/7/2022,Troup,Georgia,13285,16927,388,17315
8/7/2022,Mesa,Colorado,8077,46947,596,47543
8/7/2022,Turner,Georgia,13287,2808,63,2871
8/7/2022,Logan,Colorado,8075,7981,112,8093
8/7/2022,Lincoln,Colorado,8073,2313,10,2323
8/7/2022,Twiggs,Georgia,13289,1683,70,1753
8/7/2022,Union,Georgia,13291,5485,165,5650
8/7/2022,Unknown,Georgia,,12360,4,12364
8/7/2022,Las Animas,Colorado,8071,3904,45,3949
8/7/2022,Larimer,Colorado,8069,96457,540,96997
8/7/2022,La Plata,Colorado,8067,14429,89,14518
8/7/2022,Lake,Colorado,8065,2071,2,2073
8/7/2022,Kit Carson,Colorado,8063,1730,33,1763
8/7/2022,Kiowa,Colorado,8061,353,6,359
8/7/2022,Jefferson,Colorado,8059,147265,1420,148685
8/7/2022,Jackson,Colorado,8057,192,0,192
8/7/2022,Huerfano,Colorado,8055,1634,38,1672
8/7/2022,Hinsdale,Colorado,8053,149,0,149
8/7/2022,Gunnison,Colorado,8051,3709,14,3723
8/7/2022,Grand,Colorado,8049,3820,28,3848
8/7/2022,Gilpin,Colorado,8047,1104,5,1109
8/7/2022,Upson,Georgia,13293,8534,244,8778
8/7/2022,Walker,Georgia,13295,18480,253,18733
8/7/2022,Walton,Georgia,13297,23831,438,24269
8/7/2022,Garfield,Colorado,8045,16720,96,16816
8/7/2022,Fremont,Colorado,8043,16956,193,17149
8/7/2022,El Paso,Colorado,8041,215092,1767,216859
8/7/2022,Elbert,Colorado,8039,5411,42,5453
8/7/2022,Ware,Georgia,13299,10631,285,10916
8/7/2022,Eagle,Colorado,8037,17788,37,17825
8/7/2022,Douglas,Colorado,8035,94100,491,94591
8/7/2022,Dolores,Colorado,8033,382,8,390
8/7/2022,Warren,Georgia,13301,1169,30,1199
8/7/2022,Washington,Georgia,13303,4786,139,4925
8/7/2022,Wayne,Georgia,13305,8259,207,8466
8/7/2022,Webster,Georgia,13307,481,8,489
8/7/2022,Wheeler,Georgia,13309,1483,39,1522
8/7/2022,Denver,Colorado,8031,205368,1418,206786
8/7/2022,Delta,Colorado,8029,6685,143,6828
8/7/2022,Custer,Colorado,8027,760,22,782
8/7/2022,Crowley,Colorado,8025,3440,31,3471
8/7/2022,Costilla,Colorado,8023,843,19,862
8/7/2022,White,Georgia,13311,7427,167,7594
8/7/2022,Conejos,Colorado,8021,2073,57,2130
8/7/2022,Clear Creek,Colorado,8019,1809,12,1821
8/7/2022,Cheyenne,Colorado,8017,345,9,354
8/7/2022,Chaffee,Colorado,8015,5261,51,5312
8/7/2022,Whitfield,Georgia,13313,36061,447,36508
8/7/2022,Wilcox,Georgia,13315,2169,71,2240
8/7/2022,Broomfield,Colorado,8014,16579,121,16700
8/7/2022,Boulder,Colorado,8013,81744,388,82132
8/7/2022,Bent,Colorado,8011,2696,47,2743
8/7/2022,Baca,Colorado,8009,917,14,931
8/7/2022,Archuleta,Colorado,8007,3191,17,3208
8/7/2022,Arapahoe,Colorado,8005,183423,1350,184773
8/7/2022,Alamosa,Colorado,8003,5209,62,5271
8/7/2022,Adams,Colorado,8001,155865,1434,157299
8/7/2022,Yuba,California,6115,19669,124,19793
8/7/2022,Yolo,California,6113,49978,331,50309
8/7/2022,Ventura,California,6111,214000,1537,215537
8/7/2022,Tuolumne,California,6109,16071,196,16267
8/7/2022,Tulare,California,6107,150663,1516,152179
8/7/2022,Trinity,California,6105,1693,20,1713
8/7/2022,Tehama,California,6103,16071,209,16280
8/7/2022,Sutter,California,6101,25549,235,25784
8/7/2022,Stanislaus,California,6099,152202,1701,153903
8/7/2022,Wilkes,Georgia,13317,2382,56,2438
8/7/2022,Wilkinson,Georgia,13319,2436,60,2496
8/7/2022,Worth,Georgia,13321,5085,121,5206
8/7/2022,Sonoma,California,6097,107455,502,107957
8/7/2022,Solano,California,6095,107290,457,107747
8/7/2022,Unknown,Guam,,56894,383,57277
8/7/2022,Siskiyou,California,6093,8230,107,8337
8/7/2022,Sierra,California,6091,354,4,358
8/7/2022,Shasta,California,6089,40674,670,41344
8/7/2022,Hawaii,Hawaii,15001,36727,209,36936
8/7/2022,Honolulu,Hawaii,15003,228535,1184,229719
8/7/2022,Santa Cruz,California,6087,63113,269,63382
8/7/2022,Santa Clara,California,6085,430146,2386,432532
8/7/2022,Santa Barbara,California,6083,107114,711,107825
8/7/2022,Kalawao,Hawaii,15005,1,0,1
8/7/2022,San Mateo,California,6081,171035,795,171830
8/7/2022,San Luis Obispo,California,6079,67396,510,67906
8/7/2022,San Joaquin,California,6077,202673,2276,204949
8/7/2022,San Francisco,California,6075,182894,946,183840
8/7/2022,San Diego,California,6073,958923,5424,964347
8/7/2022,San Bernardino,California,6071,667415,7956,675371
8/7/2022,San Benito,California,6069,16223,101,16324
8/7/2022,Sacramento,California,6067,364890,3342,368232
8/7/2022,Riverside,California,6065,702197,6616,708813
8/7/2022,Plumas,California,6063,3941,13,3954
8/7/2022,Placer,California,6061,81955,648,82603
8/7/2022,Kauai,Hawaii,15007,16587,37,16624
8/7/2022,Maui,Hawaii,15009,39528,150,39678
8/7/2022,Orange,California,6059,699194,7235,706429
8/7/2022,Nevada,California,6057,19938,132,20070
8/7/2022,Napa,California,6055,32387,151,32538
8/7/2022,Unknown,Hawaii,,0,9,9
8/7/2022,Monterey,California,6053,109953,774,110727
8/7/2022,Mono,California,6051,3382,7,3389
8/7/2022,Modoc,California,6049,1166,11,1177
8/7/2022,Merced,California,6047,79923,838,80761
8/7/2022,Ada,Idaho,16001,148025,1043,149068
8/7/2022,Adams,Idaho,16003,753,15,768
8/7/2022,Mendocino,California,6045,19398,132,19530
8/7/2022,Mariposa,California,6043,3932,37,3969
8/7/2022,Marin,California,6041,48250,302,48552
8/7/2022,Madera,California,6039,49430,372,49802
8/7/2022,Los Angeles,California,6037,3326326,32826,3359152
8/7/2022,Bannock,Idaho,16005,22473,257,22730
8/7/2022,Lassen,California,6035,11295,68,11363
8/7/2022,Lake,California,6033,13297,142,13439
8/7/2022,Kings,California,6031,61168,453,61621
8/7/2022,Kern,California,6029,272015,2499,274514
8/7/2022,Bear Lake,Idaho,16007,1024,16,1040
8/7/2022,Inyo,California,6027,5209,57,5266
8/7/2022,Imperial,California,6025,77352,949,78301
8/7/2022,Humboldt,California,6023,25267,154,25421
8/7/2022,Benewah,Idaho,16009,2600,41,2641
8/7/2022,Glenn,California,6021,7156,48,7204
8/7/2022,Fresno,California,6019,291838,2815,294653
8/7/2022,El Dorado,California,6017,35232,225,35457
8/7/2022,Del Norte,California,6015,7564,54,7618
8/7/2022,Contra Costa,California,6013,256090,1383,257473
8/7/2022,Colusa,California,6011,4900,22,4922
8/7/2022,Calaveras,California,6009,8691,129,8820
8/7/2022,Bingham,Idaho,16011,10428,163,10591
8/7/2022,Blaine,Idaho,16013,6660,29,6689
8/7/2022,Boise,Idaho,16015,1204,14,1218
8/7/2022,Butte,California,6007,45848,446,46294
8/7/2022,Amador,California,6005,10485,88,10573
8/7/2022,Alpine,California,6003,131,0,131
8/7/2022,Alameda,California,6001,350942,1968,352910
8/7/2022,Yell,Arkansas,5149,7137,108,7245
8/7/2022,Woodruff,Arkansas,5147,1947,31,1978
8/7/2022,White,Arkansas,5145,24122,308,24430
8/7/2022,Washington,Arkansas,5143,73926,646,74572
8/7/2022,Van Buren,Arkansas,5141,3821,62,3883
8/7/2022,Unknown,Arkansas,,29709,0,29709
8/7/2022,Bonner,Idaho,16017,9551,191,9742
8/7/2022,Bonneville,Idaho,16019,32897,291,33188
8/7/2022,Boundary,Idaho,16021,2233,63,2296
8/7/2022,Union,Arkansas,5139,10191,184,10375
8/7/2022,Butte,Idaho,16023,509,11,520
8/7/2022,Camas,Idaho,16025,166,2,168
8/7/2022,Canyon,Idaho,16027,65517,696,66213
8/7/2022,Stone,Arkansas,5137,3235,69,3304
8/7/2022,St. Francis,Arkansas,5123,7772,97,7869
8/7/2022,Sharp,Arkansas,5135,5147,113,5260
8/7/2022,Caribou,Idaho,16029,1579,32,1611
8/7/2022,Cassia,Idaho,16031,5231,55,5286
8/7/2022,Sevier,Arkansas,5133,6490,76,6566
8/7/2022,Sebastian,Arkansas,5131,35867,545,36412
8/7/2022,Searcy,Arkansas,5129,2294,49,2343
8/7/2022,Scott,Arkansas,5127,2595,44,2639
8/7/2022,Clark,Idaho,16033,115,1,116
8/7/2022,Clearwater,Idaho,16035,2441,34,2475
8/7/2022,Saline,Arkansas,5125,33721,349,34070
8/7/2022,Randolph,Arkansas,5121,5646,94,5740
8/7/2022,Pulaski,Arkansas,5119,115824,1206,117030
8/7/2022,Prairie,Arkansas,5117,2112,43,2155
8/7/2022,Pope,Arkansas,5115,19558,215,19773
8/7/2022,Polk,Arkansas,5113,4338,151,4489
8/7/2022,Poinsett,Arkansas,5111,8778,131,8909
8/7/2022,Custer,Idaho,16037,643,9,652
8/7/2022,Pike,Arkansas,5109,2740,44,2784
8/7/2022,Elmore,Idaho,16039,8062,70,8132
8/7/2022,Franklin,Idaho,16041,2472,30,2502
8/7/2022,Phillips,Arkansas,5107,5232,100,5332
8/7/2022,Perry,Arkansas,5105,2724,38,2762
8/7/2022,Fremont,Idaho,16043,2304,30,2334
8/7/2022,Gem,Idaho,16045,3919,81,4000
8/7/2022,Ouachita,Arkansas,5103,6101,109,6210
8/7/2022,Newton,Arkansas,5101,1837,49,1886
8/7/2022,Gooding,Idaho,16047,3544,55,3599
8/7/2022,Nevada,Arkansas,5099,2415,45,2460
8/7/2022,Montgomery,Arkansas,5097,1657,56,1713
8/7/2022,Monroe,Arkansas,5095,2110,36,2146
8/7/2022,Mississippi,Arkansas,5093,14565,215,14780
8/7/2022,Miller,Arkansas,5091,10463,184,10647
8/7/2022,Marion,Arkansas,5089,3682,90,3772
8/7/2022,Idaho,Idaho,16049,3253,53,3306
8/7/2022,Jefferson,Idaho,16051,6359,65,6424
8/7/2022,Madison,Arkansas,5087,4353,65,4418
8/7/2022,Lonoke,Arkansas,5085,21788,251,22039
8/7/2022,Logan,Arkansas,5083,5475,80,5555
8/7/2022,Little River,Arkansas,5081,3520,106,3626
8/7/2022,Lincoln,Arkansas,5079,5129,69,5198
8/7/2022,Lee,Arkansas,5077,3077,62,3139
8/7/2022,Lawrence,Arkansas,5075,5780,82,5862
8/7/2022,Lafayette,Arkansas,5073,1377,30,1407
8/7/2022,Jerome,Idaho,16053,6547,64,6611
8/7/2022,Johnson,Arkansas,5071,7380,90,7470
8/7/2022,Kootenai,Idaho,16055,44439,618,45057
8/7/2022,Jefferson,Arkansas,5069,20422,282,20704
8/7/2022,Latah,Idaho,16057,7259,51,7310
8/7/2022,Jackson,Arkansas,5067,6525,65,6590
8/7/2022,Lemhi,Idaho,16059,1484,27,1511
8/7/2022,Izard,Arkansas,5065,4219,72,4291
8/7/2022,Independence,Arkansas,5063,11467,216,11683
8/7/2022,Howard,Arkansas,5061,4185,53,4238
8/7/2022,Hot Spring,Arkansas,5059,12035,142,12177
8/7/2022,Hempstead,Arkansas,5057,5119,70,5189
8/7/2022,Lewis,Idaho,16061,1232,30,1262
8/7/2022,Greene,Arkansas,5055,17345,182,17527
8/7/2022,Lincoln,Idaho,16063,1165,15,1180
8/7/2022,Grant,Arkansas,5053,4759,62,4821
8/7/2022,Garland,Arkansas,5051,24924,520,25444
8/7/2022,Fulton,Arkansas,5049,2858,95,2953
8/7/2022,Franklin,Arkansas,5047,4094,73,4167
8/7/2022,Faulkner,Arkansas,5045,38613,324,38937
8/7/2022,Drew,Arkansas,5043,4964,72,5036
8/7/2022,Desha,Arkansas,5041,3334,41,3375
8/7/2022,Dallas,Arkansas,5039,1885,33,1918
8/7/2022,Madison,Idaho,16065,13251,54,13305
8/7/2022,Cross,Arkansas,5037,5238,88,5326
8/7/2022,Crittenden,Arkansas,5035,15413,229,15642
8/7/2022,Crawford,Arkansas,5033,17152,255,17407
8/7/2022,Minidoka,Idaho,16067,4467,65,4532
8/7/2022,Nez Perce,Idaho,16069,9593,151,9744
8/7/2022,Craighead,Arkansas,5031,41251,341,41592
8/7/2022,Conway,Arkansas,5029,5847,68,5915
8/7/2022,Columbia,Arkansas,5027,5923,99,6022
8/7/2022,Cleveland,Arkansas,5025,2435,37,2472
8/7/2022,Oneida,Idaho,16071,865,11,876
8/7/2022,Cleburne,Arkansas,5023,7164,131,7295
8/7/2022,Clay,Arkansas,5021,4499,96,4595
8/7/2022,Owyhee,Idaho,16073,2416,53,2469
8/7/2022,Payette,Idaho,16075,6056,89,6145
8/7/2022,Power,Idaho,16077,1567,21,1588
8/7/2022,Shoshone,Idaho,16079,2942,77,3019
8/7/2022,Teton,Idaho,16081,2828,9,2837
8/7/2022,Clark,Arkansas,5019,5871,85,5956
8/7/2022,Chicot,Arkansas,5017,2904,59,2963
8/7/2022,Carroll,Arkansas,5015,6666,109,6775
8/7/2022,Twin Falls,Idaho,16083,26206,300,26506
8/7/2022,Calhoun,Arkansas,5013,1070,11,1081
8/7/2022,Bradley,Arkansas,5011,3249,53,3302
8/7/2022,Boone,Arkansas,5009,10209,184,10393
8/7/2022,Valley,Idaho,16085,2868,16,2884
8/7/2022,Benton,Arkansas,5007,71535,880,72415
8/7/2022,Baxter,Arkansas,5005,9733,262,9995
8/7/2022,Ashley,Arkansas,5003,5560,73,5633
8/7/2022,Arkansas,Arkansas,5001,6220,79,6299
8/7/2022,Yuma,Arizona,4027,66214,1192,67406
8/7/2022,Yavapai,Arizona,4025,53247,1252,54499
8/7/2022,Santa Cruz,Arizona,4023,17909,235,18144
8/7/2022,Pinal,Arizona,4021,143145,1698,144843
8/7/2022,Pima,Arizona,4019,281185,3925,285110
8/7/2022,Washington,Idaho,16087,2523,58,2581
8/7/2022,Navajo,Arizona,4017,42559,921,43480
8/7/2022,Mohave,Arizona,4015,62485,1508,63993
8/7/2022,Maricopa,Arizona,4013,1392047,17664,1409711
8/7/2022,Adams,Illinois,17001,24825,243,25068
8/7/2022,La Paz,Arizona,4012,5630,148,5778
8/7/2022,Greenlee,Arizona,4011,2392,39,2431
8/7/2022,Graham,Arizona,4009,12876,180,13056
8/7/2022,Gila,Arizona,4007,18943,390,19333
8/7/2022,Coconino,Arizona,4005,48448,487,48935
8/7/2022,Cochise,Arizona,4003,34895,584,35479
8/7/2022,Alexander,Illinois,17003,1422,16,1438
8/7/2022,Apache,Arizona,4001,29488,619,30107
8/7/2022,Unknown,American Samoa,,7471,33,7504
8/7/2022,Bond,Illinois,17005,4769,37,4806
8/7/2022,Boone,Illinois,17007,15554,132,15686
8/7/2022,Brown,Illinois,17009,2568,22,2590
8/7/2022,Bureau,Illinois,17011,9145,142,9287
8/7/2022,Calhoun,Illinois,17013,1678,8,1686
8/7/2022,Carroll,Illinois,17015,4613,50,4663
8/7/2022,Yukon-Koyukuk Census Area,Alaska,2290,1597,11,1608
8/7/2022,Yakutat plus Hoonah-Angoon,Alaska,,795,5,800
8/7/2022,Wrangell City and Borough,Alaska,2275,741,1,742
8/7/2022,Valdez-Cordova Census Area,Alaska,2261,3458,20,3478
8/7/2022,Unknown,Alaska,,6682,1,6683
8/7/2022,Cass,Illinois,17017,5083,44,5127
8/7/2022,Champaign,Illinois,17019,75102,305,75407
8/7/2022,Christian,Illinois,17021,11443,132,11575
8/7/2022,Southeast Fairbanks Census Area,Alaska,2240,2248,20,2268
8/7/2022,Skagway Municipality,Alaska,2230,560,0,560
8/7/2022,Clark,Illinois,17023,5283,60,5343
8/7/2022,Sitka City and Borough,Alaska,2220,3131,5,3136
8/7/2022,Prince of Wales-Hyder Census Area,Alaska,2198,1684,10,1694
8/7/2022,Petersburg Borough,Alaska,2195,864,5,869
8/7/2022,Clay,Illinois,17025,5199,75,5274
8/7/2022,Northwest Arctic Borough,Alaska,2188,5209,14,5223
8/7/2022,Clinton,Illinois,17027,12907,122,13029
8/7/2022,North Slope Borough,Alaska,2185,5065,14,5079
8/7/2022,Coles,Illinois,17029,16715,176,16891
8/7/2022,Nome Census Area,Alaska,2180,6483,5,6488
8/7/2022,Matanuska-Susitna Borough,Alaska,2170,38207,242,38449
8/7/2022,Kusilvak Census Area,Alaska,2158,4401,14,4415
8/7/2022,Cook,Illinois,17031,1347608,15180,1362788
8/7/2022,Kodiak Island Borough,Alaska,2150,5509,12,5521
8/7/2022,Ketchikan Gateway Borough,Alaska,2130,4887,20,4907
8/7/2022,Crawford,Illinois,17033,6899,62,6961
8/7/2022,Kenai Peninsula Borough,Alaska,2122,20644,104,20748
8/7/2022,Juneau City and Borough,Alaska,2110,10872,20,10892
8/7/2022,Haines Borough,Alaska,2100,738,1,739
8/7/2022,Fairbanks North Star Borough,Alaska,2090,31124,147,31271
8/7/2022,Dillingham Census Area,Alaska,2070,2069,12,2081
8/7/2022,Cumberland,Illinois,17035,3593,49,3642
8/7/2022,DeKalb,Illinois,17037,27777,206,27983
8/7/2022,De Witt,Illinois,17039,4796,47,4843
8/7/2022,Denali Borough,Alaska,2068,1497,1,1498
8/7/2022,Bristol Bay plus Lake and Peninsula,Alaska,,1165,1,1166
8/7/2022,Douglas,Illinois,17041,7112,62,7174
8/7/2022,Bethel Census Area,Alaska,2050,11354,42,11396
8/7/2022,Anchorage,Alaska,2020,116484,539,117023
8/7/2022,Aleutians West Census Area,Alaska,2016,1860,1,1861
8/7/2022,Aleutians East Borough,Alaska,2013,1187,3,1190
8/7/2022,DuPage,Illinois,17043,255154,1838,256992
8/7/2022,Edgar,Illinois,17045,5743,80,5823
8/7/2022,Edwards,Illinois,17047,1913,29,1942
8/7/2022,Effingham,Illinois,17049,11553,151,11704
8/7/2022,Fayette,Illinois,17051,7729,104,7833
8/7/2022,Ford,Illinois,17053,4878,77,4955
8/7/2022,Winston,Alabama,1133,8127,134,8261
8/7/2022,Wilcox,Alabama,1131,3205,48,3253
8/7/2022,Franklin,Illinois,17055,13489,182,13671
8/7/2022,Fulton,Illinois,17057,11416,140,11556
8/7/2022,Gallatin,Illinois,17059,1576,19,1595
8/7/2022,Washington,Alabama,1129,4016,59,4075
8/7/2022,Walker,Alabama,1127,20542,453,20995
8/7/2022,Tuscaloosa,Alabama,1125,62124,800,62924
8/7/2022,Greene,Illinois,17061,3886,59,3945
8/7/2022,Tallapoosa,Alabama,1123,12634,242,12876
8/7/2022,Talladega,Alabama,1121,24538,381,24919
8/7/2022,Sumter,Alabama,1119,2826,52,2878
8/7/2022,Grundy,Illinois,17063,14284,144,14428
8/7/2022,St. Clair,Alabama,1115,28123,424,28547
8/7/2022,Shelby,Alabama,1117,67139,464,67603
8/7/2022,Russell,Alabama,1113,11362,96,11458
8/7/2022,Hamilton,Illinois,17065,2365,35,2400
8/7/2022,Randolph,Alabama,1111,5504,75,5579
8/7/2022,Pike,Alabama,1109,8152,137,8289
8/7/2022,Pickens,Alabama,1107,5601,105,5706
8/7/2022,Perry,Alabama,1105,2331,47,2378
8/7/2022,Hancock,Illinois,17067,4821,58,4879
8/7/2022,Hardin,Illinois,17069,1169,20,1189
8/7/2022,Morgan,Alabama,1103,39913,524,40437
8/7/2022,Montgomery,Alabama,1101,63328,971,64299
8/7/2022,Monroe,Alabama,1099,5863,81,5944
8/7/2022,Mobile,Alabama,1097,123099,1687,124786
8/7/2022,Marshall,Alabama,1095,29159,398,29557
8/7/2022,Marion,Alabama,1093,8862,153,9015
8/7/2022,Henderson,Illinois,17071,1305,28,1333
8/7/2022,Marengo,Alabama,1091,5623,108,5731
8/7/2022,Henry,Illinois,17073,13991,150,14141
8/7/2022,Madison,Alabama,1089,100807,991,101798
8/7/2022,Macon,Alabama,1087,4452,86,4538
8/7/2022,Lowndes,Alabama,1085,2912,79,2991
8/7/2022,Limestone,Alabama,1083,27661,299,27960
8/7/2022,Iroquois,Illinois,17075,7928,122,8050
8/7/2022,Jackson,Illinois,17077,17763,135,17898
8/7/2022,Jasper,Illinois,17079,2879,33,2912
8/7/2022,Jefferson,Illinois,17081,12055,177,12232
8/7/2022,Lee,Alabama,1081,41892,346,42238
8/7/2022,Lawrence,Alabama,1079,8261,168,8429
8/7/2022,Lauderdale,Alabama,1077,26436,404,26840
8/7/2022,Lamar,Alabama,1075,4100,66,4166
8/7/2022,Jefferson,Alabama,1073,207512,2402,209914
8/7/2022,Jackson,Alabama,1071,16094,246,16340
8/7/2022,Houston,Alabama,1069,28551,513,29064
8/7/2022,Henry,Alabama,1067,5106,78,5184
8/7/2022,Hale,Alabama,1065,5190,109,5299
8/7/2022,Jersey,Illinois,17083,6920,92,7012
8/7/2022,Jo Daviess,Illinois,17085,4521,40,4561
8/7/2022,Johnson,Illinois,17087,4902,47,4949
8/7/2022,Kane,Illinois,17089,146771,1200,147971
8/7/2022,Kankakee,Illinois,17091,32287,381,32668
8/7/2022,Kendall,Illinois,17093,36865,173,37038
8/7/2022,Knox,Illinois,17095,14235,251,14486
8/7/2022,Greene,Alabama,1063,2056,51,2107
8/7/2022,Lake,Illinois,17097,182349,1504,183853
8/7/2022,Geneva,Alabama,1061,7068,165,7233
8/7/2022,Franklin,Alabama,1059,10417,140,10557
8/7/2022,Fayette,Alabama,1057,5224,97,5321
8/7/2022,Etowah,Alabama,1055,30473,658,31131
8/7/2022,Escambia,Alabama,1053,11016,175,11191
8/7/2022,Elmore,Alabama,1051,26195,352,26547
8/7/2022,DeKalb,Alabama,1049,20047,334,20381
8/7/2022,Dallas,Alabama,1047,9598,249,9847
8/7/2022,LaSalle,Illinois,17099,32794,450,33244
8/7/2022,Lawrence,Illinois,17101,5890,53,5943
8/7/2022,Lee,Illinois,17103,10059,119,10178
8/7/2022,Livingston,Illinois,17105,11844,149,11993
8/7/2022,Dale,Alabama,1045,14477,235,14712
8/7/2022,Logan,Illinois,17107,11074,106,11180
8/7/2022,Cullman,Alabama,1043,27070,371,27441
8/7/2022,Macon,Illinois,17115,35034,363,35397
8/7/2022,Macoupin,Illinois,17117,14170,172,14342
8/7/2022,Madison,Illinois,17119,79066,879,79945
8/7/2022,Marion,Illinois,17121,12945,219,13164
8/7/2022,Marshall,Illinois,17123,3134,34,3168
8/7/2022,Mason,Illinois,17125,4325,64,4389
8/7/2022,Van Wert,Ohio,39161,7212,149,7361
8/7/2022,Crenshaw,Alabama,1041,4167,102,4269
8/7/2022,Covington,Alabama,1039,10286,241,10527
8/7/2022,Coosa,Alabama,1037,3269,59,3328
8/7/2022,Conecuh,Alabama,1035,3187,71,3258
8/7/2022,Massac,Illinois,17127,4192,74,4266
8/7/2022,McDonough,Illinois,17109,8067,112,8179
8/7/2022,Colbert,Alabama,1033,18128,265,18393
8/7/2022,Coffee,Alabama,1031,15112,237,15349
8/7/2022,McHenry,Illinois,17111,87293,520,87813
8/7/2022,McLean,Illinois,17113,58063,343,58406
8/7/2022,Menard,Illinois,17129,4001,27,4028
8/7/2022,Mercer,Illinois,17131,4442,51,4493
8/7/2022,Cleburne,Alabama,1029,3749,69,3818
8/7/2022,Clay,Alabama,1027,4474,83,4557
8/7/2022,Clarke,Alabama,1025,7728,103,7831
8/7/2022,Choctaw,Alabama,1023,2147,37,2184
8/7/2022,Monroe,Illinois,17133,10360,131,10491
8/7/2022,Chilton,Alabama,1021,11850,212,12062
8/7/2022,Cherokee,Alabama,1019,5581,87,5668
8/7/2022,Chambers,Alabama,1017,9500,165,9665
8/7/2022,Montgomery,Illinois,17135,10658,111,10769
8/7/2022,Morgan,Illinois,17137,10807,149,10956
8/7/2022,Calhoun,Alabama,1015,34792,639,35431
8/7/2022,Butler,Alabama,1013,5607,129,5736
8/7/2022,Bullock,Alabama,1011,2631,54,2685
8/7/2022,Moultrie,Illinois,17139,4449,55,4504
8/7/2022,Blount,Alabama,1009,16095,250,16345
8/7/2022,Bibb,Alabama,1007,6996,105,7101
8/7/2022,Ogle,Illinois,17141,15520,137,15657
8/7/2022,Barbour,Alabama,1005,6382,101,6483
8/7/2022,Baldwin,Alabama,1003,62486,691,63177
8/7/2022,Autauga,Alabama,1001,17605,221,17826
8/7/2022,Peoria,Illinois,17143,53684,552,54236
8/7/2022,Perry,Illinois,17145,8066,106,8172
8/7/2022,Piatt,Illinois,17147,4969,29,4998
8/7/2022,Pike,Illinois,17149,5478,71,5549
8/7/2022,Pope,Illinois,17151,1058,9,1067
8/7/2022,Pulaski,Illinois,17153,1873,21,1894
8/7/2022,Putnam,Illinois,17155,1265,11,1276
8/7/2022,Randolph,Illinois,17157,11407,137,11544
8/7/2022,Richland,Illinois,17159,5609,85,5694
8/7/2022,Rock Island,Illinois,17161,37524,534,38058
8/7/2022,Saline,Illinois,17165,8883,113,8996
8/7/2022,Comanche,Oklahoma,40031,35324,402,35726
8/7/2022,Sangamon,Illinois,17167,65887,451,66338
8/7/2022,Schuyler,Illinois,17169,2246,29,2275
8/7/2022,Scott,Illinois,17171,1389,13,1402
8/7/2022,Shelby,Illinois,17173,6753,81,6834
8/7/2022,Stark,Illinois,17175,1669,37,1706
8/7/2022,St. Clair,Illinois,17163,78813,790,79603
8/7/2022,Stephenson,Illinois,17177,12994,187,13181
8/7/2022,Tazewell,Illinois,17179,41501,516,42017
8/7/2022,Union,Illinois,17181,6036,70,6106
8/7/2022,Unknown,Illinois,,0,2542,2542
8/7/2022,Vermilion,Illinois,17183,31199,316,31515
8/7/2022,Wabash,Illinois,17185,4112,31,4143
8/7/2022,Warren,Illinois,17187,4492,90,4582
8/7/2022,Washington,Illinois,17189,3704,42,3746
8/7/2022,Wayne,Illinois,17191,5836,85,5921
8/7/2022,White,Illinois,17193,4746,59,4805
8/7/2022,Whiteside,Illinois,17195,17316,276,17592
8/7/2022,Will,Illinois,17197,190603,1654,192257
8/7/2022,Williamson,Illinois,17199,25285,269,25554
8/7/2022,Winnebago,Illinois,17201,87869,876,88745
8/7/2022,Woodford,Illinois,17203,11428,127,11555
8/7/2022,Adams,Indiana,18001,7754,117,7871
8/7/2022,Allen,Indiana,18003,111532,1208,112740
8/7/2022,Bartholomew,Indiana,18005,23627,253,23880
8/7/2022,Benton,Indiana,18007,2665,23,2688
8/7/2022,Blackford,Indiana,18009,3352,69,3421
8/7/2022,Boone,Indiana,18011,16461,193,16654
8/7/2022,Brown,Indiana,18013,2796,62,2858
8/7/2022,Carroll,Indiana,18015,4534,71,4605
8/7/2022,Cass,Indiana,18017,12597,169,12766
8/7/2022,Clark,Indiana,18019,35332,404,35736
8/7/2022,Clay,Indiana,18021,7368,94,7462
8/7/2022,Clinton,Indiana,18023,9814,136,9950
8/7/2022,Crawford,Indiana,18025,2762,41,2803
8/7/2022,Daviess,Indiana,18027,7957,155,8112
8/7/2022,Dearborn,Indiana,18029,14499,142,14641
8/7/2022,Decatur,Indiana,18031,7553,148,7701
8/7/2022,DeKalb,Indiana,18033,12141,154,12295
8/7/2022,Delaware,Indiana,18035,27022,457,27479
8/7/2022,Dubois,Indiana,18037,13540,165,13705
8/7/2022,Elkhart,Indiana,18039,56803,747,57550
8/7/2022,Fayette,Indiana,18041,7301,151,7452
8/7/2022,Floyd,Indiana,18043,21212,309,21521
8/7/2022,Fountain,Indiana,18045,5879,106,5985
8/7/2022,Franklin,Indiana,18047,4648,67,4715
8/7/2022,Fulton,Indiana,18049,5207,106,5313
8/7/2022,Gibson,Indiana,18051,12675,151,12826
8/7/2022,Grant,Indiana,18053,18706,362,19068
8/7/2022,Greene,Indiana,18055,7925,143,8068
8/7/2022,Hamilton,Indiana,18057,89739,684,90423
8/7/2022,Hancock,Indiana,18059,22435,269,22704
8/7/2022,Harrison,Indiana,18061,11801,143,11944
8/7/2022,Hendricks,Indiana,18063,43965,565,44530
8/7/2022,Henry,Indiana,18065,14184,236,14420
8/7/2022,Howard,Indiana,18067,27347,457,27804
8/7/2022,Huntington,Indiana,18069,12487,159,12646
8/7/2022,Jackson,Indiana,18071,13518,134,13652
8/7/2022,Jasper,Indiana,18073,9907,152,10059
8/7/2022,Jay,Indiana,18075,5225,78,5303
8/7/2022,Jefferson,Indiana,18077,9804,163,9967
8/7/2022,Jennings,Indiana,18079,7376,111,7487
8/7/2022,Johnson,Indiana,18081,45908,624,46532
8/7/2022,Knox,Indiana,18083,11924,154,12078
8/7/2022,Kosciusko,Indiana,18085,20917,238,21155
8/7/2022,LaGrange,Indiana,18087,6044,104,6148
8/7/2022,Lake,Indiana,18089,118917,1870,120787
8/7/2022,LaPorte,Indiana,18091,28313,376,28689
8/7/2022,Lawrence,Indiana,18093,13189,266,13455
8/7/2022,Madison,Indiana,18095,35250,665,35915
8/7/2022,Marion,Indiana,18097,244945,3049,247994
8/7/2022,Marshall,Indiana,18099,12938,202,13140
8/7/2022,Martin,Indiana,18101,2330,25,2355
8/7/2022,Miami,Indiana,18103,9847,164,10011
8/7/2022,Monroe,Indiana,18105,31389,290,31679
8/7/2022,Montgomery,Indiana,18107,11349,167,11516
8/7/2022,Morgan,Indiana,18109,17823,291,18114
8/7/2022,Newton,Indiana,18111,2834,69,2903
8/7/2022,Noble,Indiana,18113,13991,162,14153
8/7/2022,Ohio,Indiana,18115,1567,19,1586
8/7/2022,Orange,Indiana,18117,5412,99,5511
8/7/2022,Owen,Indiana,18119,6357,127,6484
8/7/2022,Parke,Indiana,18121,3832,47,3879
8/7/2022,Perry,Indiana,18123,5084,69,5153
8/7/2022,Pike,Indiana,18125,4023,51,4074
8/7/2022,Porter,Indiana,18127,42379,577,42956
8/7/2022,Posey,Indiana,18129,7094,59,7153
8/7/2022,Pulaski,Indiana,18131,3232,87,3319
8/7/2022,Putnam,Indiana,18133,10032,131,10163
8/7/2022,Randolph,Indiana,18135,6296,150,6446
8/7/2022,Ripley,Indiana,18137,8895,140,9035
8/7/2022,Rush,Indiana,18139,5223,59,5282
8/7/2022,Scott,Indiana,18143,8501,109,8610
8/7/2022,Shelby,Indiana,18145,14865,184,15049
8/7/2022,Spencer,Indiana,18147,5550,61,5611
8/7/2022,Starke,Indiana,18149,5068,102,5170
8/7/2022,Steuben,Indiana,18151,10337,122,10459
8/7/2022,St. Joseph,Indiana,18141,76670,894,77564
8/7/2022,Sullivan,Indiana,18153,5693,77,5770
8/7/2022,Switzerland,Indiana,18155,2388,20,2408
8/7/2022,Tippecanoe,Indiana,18157,55759,415,56174
8/7/2022,Tipton,Indiana,18159,3731,88,3819
8/7/2022,Union,Indiana,18161,2122,22,2144
8/7/2022,Unknown,Indiana,,0,52,52
8/7/2022,Vanderburgh,Indiana,18163,63140,645,63785
8/7/2022,Vermillion,Indiana,18165,4484,80,4564
8/7/2022,Vigo,Indiana,18167,31257,416,31673
8/7/2022,Wabash,Indiana,18169,9265,161,9426
8/7/2022,Warren,Indiana,18171,2206,30,2236
8/7/2022,Warrick,Indiana,18173,22209,244,22453
8/7/2022,Washington,Indiana,18175,6370,88,6458
8/7/2022,Wayne,Indiana,18177,20656,341,20997
8/7/2022,Wells,Indiana,18179,6877,134,7011
8/7/2022,White,Indiana,18181,7441,98,7539
8/7/2022,Whitley,Indiana,18183,10249,86,10335
8/7/2022,Adair,Iowa,19001,1660,51,1711
8/7/2022,Adams,Iowa,19003,849,14,863
8/7/2022,Allamakee,Iowa,19005,2999,60,3059
8/7/2022,Appanoose,Iowa,19007,3066,70,3136
8/7/2022,Audubon,Iowa,19009,1170,21,1191
8/7/2022,Benton,Iowa,19011,6487,80,6567
8/7/2022,Black Hawk,Iowa,19013,35442,495,35937
8/7/2022,Boone,Iowa,19015,5904,59,5963
8/7/2022,Bremer,Iowa,19017,5898,84,5982
8/7/2022,Buchanan,Iowa,19019,5013,60,5073
8/7/2022,Buena Vista,Iowa,19021,6543,59,6602
8/7/2022,Butler,Iowa,19023,3448,54,3502
8/7/2022,Calhoun,Iowa,19025,2782,25,2807
8/7/2022,Carroll,Iowa,19027,5274,74,5348
8/7/2022,Cass,Iowa,19029,3060,78,3138
8/7/2022,Cedar,Iowa,19031,4525,37,4562
8/7/2022,Cerro Gordo,Iowa,19033,11817,172,11989
8/7/2022,Coal,Oklahoma,40029,1807,24,1831
8/7/2022,Cherokee,Iowa,19035,3186,66,3252
8/7/2022,Chickasaw,Iowa,19037,2891,33,2924
8/7/2022,Clarke,Iowa,19039,2438,39,2477
8/7/2022,Clay,Iowa,19041,4371,45,4416
8/7/2022,Clayton,Iowa,19043,3699,74,3773
8/7/2022,Clinton,Iowa,19045,12466,149,12615
8/7/2022,Crawford,Iowa,19047,4644,54,4698
8/7/2022,Dallas,Iowa,19049,24938,150,25088
8/7/2022,Davis,Iowa,19051,1688,34,1722
8/7/2022,Decatur,Iowa,19053,1635,26,1661
8/7/2022,Delaware,Iowa,19055,4312,68,4380
8/7/2022,Des Moines,Iowa,19057,9937,143,10080
8/7/2022,Dickinson,Iowa,19059,4336,75,4411
8/7/2022,Dubuque,Iowa,19061,28277,302,28579
8/7/2022,Emmet,Iowa,19063,2450,54,2504
8/7/2022,Fayette,Iowa,19065,4411,78,4489
8/7/2022,Floyd,Iowa,19067,3846,62,3908
8/7/2022,Franklin,Iowa,19069,2702,44,2746
8/7/2022,Fremont,Iowa,19071,1481,26,1507
8/7/2022,Greene,Iowa,19073,1845,23,1868
8/7/2022,Grundy,Iowa,19075,2720,45,2765
8/7/2022,Guthrie,Iowa,19077,2501,47,2548
8/7/2022,Hamilton,Iowa,19079,3645,75,3720
8/7/2022,Hancock,Iowa,19081,3036,48,3084
8/7/2022,Hardin,Iowa,19083,4459,63,4522
8/7/2022,Harrison,Iowa,19085,3574,95,3669
8/7/2022,Henry,Iowa,19087,5910,77,5987
8/7/2022,Howard,Iowa,19089,2171,36,2207
8/7/2022,Humboldt,Iowa,19091,2790,38,2828
8/7/2022,Ida,Iowa,19093,1906,49,1955
8/7/2022,Iowa,Iowa,19095,3960,50,4010
8/7/2022,Jackson,Iowa,19097,5011,71,5082
8/7/2022,Jasper,Iowa,19099,9379,113,9492
8/7/2022,Jefferson,Iowa,19101,3784,52,3836
8/7/2022,Johnson,Iowa,19103,40094,156,40250
8/7/2022,Jones,Iowa,19105,5923,74,5997
8/7/2022,Keokuk,Iowa,19107,2201,49,2250
8/7/2022,Kossuth,Iowa,19109,4006,89,4095
8/7/2022,Lee,Iowa,19111,8275,143,8418
8/7/2022,Linn,Iowa,19113,57966,604,58570
8/7/2022,Louisa,Iowa,19115,2673,63,2736
8/7/2022,Lucas,Iowa,19117,1896,32,1928
8/7/2022,Lyon,Iowa,19119,2857,52,2909
8/7/2022,Madison,Iowa,19121,3349,41,3390
8/7/2022,Mahaska,Iowa,19123,5247,90,5337
8/7/2022,Marion,Iowa,19125,8050,127,8177
8/7/2022,Marshall,Iowa,19127,10228,115,10343
8/7/2022,Mills,Iowa,19129,3629,45,3674
8/7/2022,Mitchell,Iowa,19131,2620,49,2669
8/7/2022,Monona,Iowa,19133,1824,51,1875
8/7/2022,Monroe,Iowa,19135,2001,51,2052
8/7/2022,Montgomery,Iowa,19137,2348,56,2404
8/7/2022,Muscatine,Iowa,19139,10302,132,10434
8/7/2022,O'Brien,Iowa,19141,3589,72,3661
8/7/2022,Osceola,Iowa,19143,1428,22,1450
8/7/2022,Page,Iowa,19145,3495,49,3544
8/7/2022,Palo Alto,Iowa,19147,2162,38,2200
8/7/2022,Plymouth,Iowa,19149,6589,104,6693
8/7/2022,Pocahontas,Iowa,19151,1737,27,1764
8/7/2022,Polk,Iowa,19153,135993,1135,137128
8/7/2022,Pottawattamie,Iowa,19155,25745,323,26068
8/7/2022,Poweshiek,Iowa,19157,4096,63,4159
8/7/2022,Ringgold,Iowa,19159,1185,35,1220
8/7/2022,Sac,Iowa,19161,2586,36,2622
8/7/2022,Scott,Iowa,19163,44649,409,45058
8/7/2022,Shelby,Iowa,19165,2890,52,2942
8/7/2022,Sioux,Iowa,19167,8287,90,8377
8/7/2022,Story,Iowa,19169,21325,92,21417
8/7/2022,Tama,Iowa,19171,4205,95,4300
8/7/2022,Taylor,Iowa,19173,1372,22,1394
8/7/2022,Union,Iowa,19175,2884,53,2937
8/7/2022,Unknown,Iowa,,444,0,444
8/7/2022,Van Buren,Iowa,19177,1488,27,1515
8/7/2022,Wapello,Iowa,19179,9536,210,9746
8/7/2022,Warren,Iowa,19181,13369,137,13506
8/7/2022,Washington,Iowa,19183,6086,80,6166
8/7/2022,Wayne,Iowa,19185,1360,33,1393
8/7/2022,Webster,Iowa,19187,11056,169,11225
8/7/2022,Winnebago,Iowa,19189,3182,47,3229
8/7/2022,Winneshiek,Iowa,19191,4157,53,4210
8/7/2022,Woodbury,Iowa,19193,30433,344,30777
8/7/2022,Worth,Iowa,19195,1871,17,1888
8/7/2022,Wright,Iowa,19197,3772,67,3839
8/7/2022,Allen,Kansas,20001,4398,58,4456
8/7/2022,Anderson,Kansas,20003,2302,35,2337
8/7/2022,Atchison,Kansas,20005,4614,39,4653
8/7/2022,Barber,Kansas,20007,1095,9,1104
8/7/2022,Barton,Kansas,20009,6855,107,6962
8/7/2022,Bourbon,Kansas,20011,4895,56,4951
8/7/2022,Brown,Kansas,20013,2904,49,2953
8/7/2022,Butler,Kansas,20015,20283,200,20483
8/7/2022,Chase,Kansas,20017,720,7,727
8/7/2022,Chautauqua,Kansas,20019,888,18,906
8/7/2022,Cherokee,Kansas,20021,6614,89,6703
8/7/2022,Cheyenne,Kansas,20023,672,14,686
8/7/2022,Clark,Kansas,20025,525,8,533
8/7/2022,Clay,Kansas,20027,2132,38,2170
8/7/2022,Cloud,Kansas,20029,2366,42,2408
8/7/2022,Coffey,Kansas,20031,2554,45,2599
8/7/2022,Comanche,Kansas,20033,452,17,469
8/7/2022,Cowley,Kansas,20035,11042,163,11205
8/7/2022,Crawford,Kansas,20037,13122,133,13255
8/7/2022,Decatur,Kansas,20039,638,20,658
8/7/2022,Dickinson,Kansas,20041,5187,87,5274
8/7/2022,Doniphan,Kansas,20043,2597,34,2631
8/7/2022,Douglas,Kansas,20045,30539,143,30682
8/7/2022,Edwards,Kansas,20047,609,13,622
8/7/2022,Elk,Kansas,20049,609,12,621
8/7/2022,Ellis,Kansas,20051,7558,86,7644
8/7/2022,Ellsworth,Kansas,20053,2135,32,2167
8/7/2022,Finney,Kansas,20055,12331,117,12448
8/7/2022,Ford,Kansas,20057,11288,117,11405
8/7/2022,Franklin,Kansas,20059,7408,93,7501
8/7/2022,Geary,Kansas,20061,10064,78,10142
8/7/2022,Gove,Kansas,20063,837,23,860
8/7/2022,Graham,Kansas,20065,612,15,627
8/7/2022,Grant,Kansas,20067,2422,37,2459
8/7/2022,Gray,Kansas,20069,1262,22,1284
8/7/2022,Greeley,Kansas,20071,360,3,363
8/7/2022,Greenwood,Kansas,20073,1903,26,1929
8/7/2022,Hamilton,Kansas,20075,508,4,512
8/7/2022,Harper,Kansas,20077,1736,28,1764
8/7/2022,Harvey,Kansas,20079,10488,125,10613
8/7/2022,Haskell,Kansas,20081,1003,12,1015
8/7/2022,Hodgeman,Kansas,20083,439,11,450
8/7/2022,Jackson,Kansas,20085,4179,31,4210
8/7/2022,Jefferson,Kansas,20087,5162,68,5230
8/7/2022,Jewell,Kansas,20089,847,15,862
8/7/2022,Johnson,Kansas,20091,162843,1252,164095
8/7/2022,Kearny,Kansas,20093,1299,21,1320
8/7/2022,Kingman,Kansas,20095,2092,28,2120
8/7/2022,Kiowa,Kansas,20097,695,7,702
8/7/2022,Labette,Kansas,20099,7057,80,7137
8/7/2022,Lane,Kansas,20101,318,12,330
8/7/2022,Leavenworth,Kansas,20103,21417,199,21616
8/7/2022,Lincoln,Kansas,20105,647,11,658
8/7/2022,Linn,Kansas,20107,3036,32,3068
8/7/2022,Logan,Kansas,20109,897,13,910
8/7/2022,Lyon,Kansas,20111,10685,126,10811
8/7/2022,Marion,Kansas,20115,3544,46,3590
8/7/2022,Marshall,Kansas,20117,2670,44,2714
8/7/2022,McPherson,Kansas,20113,8393,130,8523
8/7/2022,Meade,Kansas,20119,1256,22,1278
8/7/2022,Miami,Kansas,20121,8550,100,8650
8/7/2022,Mitchell,Kansas,20123,1536,24,1560
8/7/2022,Montgomery,Kansas,20125,9959,166,10125
8/7/2022,Morris,Kansas,20127,1591,30,1621
8/7/2022,Morton,Kansas,20129,651,11,662
8/7/2022,Nemaha,Kansas,20131,3471,60,3531
8/7/2022,Neosho,Kansas,20133,5523,69,5592
8/7/2022,Ness,Kansas,20135,801,19,820
8/7/2022,Norton,Kansas,20137,2199,36,2235
8/7/2022,Osage,Kansas,20139,4234,61,4295
8/7/2022,Osborne,Kansas,20141,859,19,878
8/7/2022,Ottawa,Kansas,20143,1274,23,1297
8/7/2022,Pawnee,Kansas,20145,2294,25,2319
8/7/2022,Phillips,Kansas,20147,1448,30,1478
8/7/2022,Pottawatomie,Kansas,20149,6248,63,6311
8/7/2022,Pratt,Kansas,20151,2043,35,2078
8/7/2022,Rawlins,Kansas,20153,704,9,713
8/7/2022,Reno,Kansas,20155,20153,245,20398
8/7/2022,Republic,Kansas,20157,1403,19,1422
8/7/2022,Rice,Kansas,20159,2783,27,2810
8/7/2022,Riley,Kansas,20161,14674,93,14767
8/7/2022,Rooks,Kansas,20163,1426,21,1447
8/7/2022,Rush,Kansas,20165,842,19,861
8/7/2022,Russell,Kansas,20167,1933,38,1971
8/7/2022,Saline,Kansas,20169,15212,251,15463
8/7/2022,Scott,Kansas,20171,1387,34,1421
8/7/2022,Sedgwick,Kansas,20173,155622,1476,157098
8/7/2022,Seward,Kansas,20175,7350,62,7412
8/7/2022,Shawnee,Kansas,20177,53677,650,54327
8/7/2022,Sheridan,Kansas,20179,815,17,832
8/7/2022,Sherman,Kansas,20181,1602,22,1624
8/7/2022,Smith,Kansas,20183,680,9,689
8/7/2022,Stafford,Kansas,20185,1221,28,1249
8/7/2022,Stanton,Kansas,20187,444,9,453
8/7/2022,Stevens,Kansas,20189,1649,24,1673
8/7/2022,Sumner,Kansas,20191,6010,76,6086
8/7/2022,Thomas,Kansas,20193,2642,29,2671
8/7/2022,Trego,Kansas,20195,812,12,824
8/7/2022,Wabaunsee,Kansas,20197,1738,23,1761
8/7/2022,Wallace,Kansas,20199,458,8,466
8/7/2022,Washington,Kansas,20201,1466,23,1489
8/7/2022,Wichita,Kansas,20203,551,8,559
8/7/2022,Wilson,Kansas,20205,3004,50,3054
8/7/2022,Woodson,Kansas,20207,880,17,897
8/7/2022,Wyandotte,Kansas,20209,50615,521,51136
8/7/2022,Adair,Kentucky,21001,6535,110,6645
8/7/2022,Cleveland,Oklahoma,40027,86726,831,87557
8/7/2022,Allen,Kentucky,21003,7250,111,7361
8/7/2022,Anderson,Kentucky,21005,7326,72,7398
8/7/2022,Ballard,Kentucky,21007,1579,34,1613
8/7/2022,Barren,Kentucky,21009,14211,223,14434
8/7/2022,Bath,Kentucky,21011,3609,49,3658
8/7/2022,Bell,Kentucky,21013,9477,161,9638
8/7/2022,Boone,Kentucky,21015,43715,312,44027
8/7/2022,Bourbon,Kentucky,21017,6701,62,6763
8/7/2022,Boyd,Kentucky,21019,18553,184,18737
8/7/2022,Boyle,Kentucky,21021,9719,141,9860
8/7/2022,Bracken,Kentucky,21023,2411,27,2438
8/7/2022,Breathitt,Kentucky,21025,4311,56,4367
8/7/2022,Breckinridge,Kentucky,21027,5592,82,5674
8/7/2022,Bullitt,Kentucky,21029,24479,232,24711
8/7/2022,Butler,Kentucky,21031,4094,55,4149
8/7/2022,Caldwell,Kentucky,21033,4490,63,4553
8/7/2022,Calloway,Kentucky,21035,9989,98,10087
8/7/2022,Campbell,Kentucky,21037,27479,190,27669
8/7/2022,Carlisle,Kentucky,21039,1179,20,1199
8/7/2022,Carroll,Kentucky,21041,3711,50,3761
8/7/2022,Carter,Kentucky,21043,9774,109,9883
8/7/2022,Casey,Kentucky,21045,4508,76,4584
8/7/2022,Christian,Kentucky,21047,17740,215,17955
8/7/2022,Clark,Kentucky,21049,12110,73,12183
8/7/2022,Clay,Kentucky,21051,8269,97,8366
8/7/2022,Clinton,Kentucky,21053,4004,53,4057
8/7/2022,Crittenden,Kentucky,21055,2520,51,2571
8/7/2022,Cumberland,Kentucky,21057,2390,33,2423
8/7/2022,Daviess,Kentucky,21059,33904,397,34301
8/7/2022,Edmonson,Kentucky,21061,2769,50,2819
8/7/2022,Elliott,Kentucky,21063,2914,20,2934
8/7/2022,Estill,Kentucky,21065,4387,52,4439
8/7/2022,Fayette,Kentucky,21067,107148,638,107786
8/7/2022,Fleming,Kentucky,21069,4338,64,4402
8/7/2022,Floyd,Kentucky,21071,13823,226,14049
8/7/2022,Franklin,Kentucky,21073,15668,159,15827
8/7/2022,Fulton,Kentucky,21075,1321,33,1354
8/7/2022,Gallatin,Kentucky,21077,2362,52,2414
8/7/2022,Garrard,Kentucky,21079,5209,83,5292
8/7/2022,Grant,Kentucky,21081,8640,68,8708
8/7/2022,Graves,Kentucky,21083,12275,186,12461
8/7/2022,Grayson,Kentucky,21085,8687,138,8825
8/7/2022,Green,Kentucky,21087,4019,46,4065
8/7/2022,Greenup,Kentucky,21089,13706,151,13857
8/7/2022,Hancock,Kentucky,21091,2722,26,2748
8/7/2022,Hardin,Kentucky,21093,36984,451,37435
8/7/2022,Harlan,Kentucky,21095,9907,216,10123
8/7/2022,Harrison,Kentucky,21097,7279,82,7361
8/7/2022,Hart,Kentucky,21099,5858,106,5964
8/7/2022,Henderson,Kentucky,21101,15219,174,15393
8/7/2022,Henry,Kentucky,21103,5493,53,5546
8/7/2022,Hickman,Kentucky,21105,959,28,987
8/7/2022,Hopkins,Kentucky,21107,16360,260,16620
8/7/2022,Jackson,Kentucky,21109,4541,83,4624
8/7/2022,Jefferson,Kentucky,21111,265475,2449,267924
8/7/2022,Jessamine,Kentucky,21113,16728,150,16878
8/7/2022,Johnson,Kentucky,21115,7282,125,7407
8/7/2022,Kenton,Kentucky,21117,50415,439,50854
8/7/2022,Knott,Kentucky,21119,4781,66,4847
8/7/2022,Knox,Kentucky,21121,12524,153,12677
8/7/2022,Larue,Kentucky,21123,4130,75,4205
8/7/2022,Laurel,Kentucky,21125,22288,253,22541
8/7/2022,Lawrence,Kentucky,21127,4860,75,4935
8/7/2022,Lee,Kentucky,21129,3084,56,3140
8/7/2022,Leslie,Kentucky,21131,4133,49,4182
8/7/2022,Letcher,Kentucky,21133,7929,123,8052
8/7/2022,Lewis,Kentucky,21135,4914,89,5003
8/7/2022,Lincoln,Kentucky,21137,7380,139,7519
8/7/2022,Livingston,Kentucky,21139,2751,62,2813
8/7/2022,Logan,Kentucky,21141,9000,129,9129
8/7/2022,Lyon,Kentucky,21143,3271,37,3308
8/7/2022,Madison,Kentucky,21151,30507,288,30795
8/7/2022,Magoffin,Kentucky,21153,4341,54,4395
8/7/2022,Marion,Kentucky,21155,6966,86,7052
8/7/2022,Marshall,Kentucky,21157,9037,117,9154
8/7/2022,Martin,Kentucky,21159,3570,49,3619
8/7/2022,Mason,Kentucky,21161,5441,109,5550
8/7/2022,McCracken,Kentucky,21145,21524,284,21808
8/7/2022,McCreary,Kentucky,21147,6065,84,6149
8/7/2022,McLean,Kentucky,21149,2862,53,2915
8/7/2022,Meade,Kentucky,21163,6365,66,6431
8/7/2022,Menifee,Kentucky,21165,1893,34,1927
8/7/2022,Mercer,Kentucky,21167,8102,108,8210
8/7/2022,Metcalfe,Kentucky,21169,3178,69,3247
8/7/2022,Monroe,Kentucky,21171,3909,82,3991
8/7/2022,Montgomery,Kentucky,21173,9680,110,9790
8/7/2022,Morgan,Kentucky,21175,5726,33,5759
8/7/2022,Muhlenberg,Kentucky,21177,11256,125,11381
8/7/2022,Nelson,Kentucky,21179,16050,158,16208
8/7/2022,Nicholas,Kentucky,21181,2318,32,2350
8/7/2022,Ohio,Kentucky,21183,7918,105,8023
8/7/2022,Oldham,Kentucky,21185,20224,146,20370
8/7/2022,Owen,Kentucky,21187,2649,34,2683
8/7/2022,Owsley,Kentucky,21189,1648,30,1678
8/7/2022,Pendleton,Kentucky,21191,3724,40,3764
8/7/2022,Perry,Kentucky,21193,12454,186,12640
8/7/2022,Pike,Kentucky,21195,21182,325,21507
8/7/2022,Powell,Kentucky,21197,5209,45,5254
8/7/2022,Pulaski,Kentucky,21199,19545,298,19843
8/7/2022,Robertson,Kentucky,21201,742,21,763
8/7/2022,Rockcastle,Kentucky,21203,5401,63,5464
8/7/2022,Rowan,Kentucky,21205,7614,74,7688
8/7/2022,Russell,Kentucky,21207,6977,89,7066
8/7/2022,Scott,Kentucky,21209,19895,116,20011
8/7/2022,Shelby,Kentucky,21211,14737,168,14905
8/7/2022,Simpson,Kentucky,21213,6261,96,6357
8/7/2022,Spencer,Kentucky,21215,5955,63,6018
8/7/2022,Taylor,Kentucky,21217,10311,129,10440
8/7/2022,Todd,Kentucky,21219,3151,46,3197
8/7/2022,Trigg,Kentucky,21221,4367,45,4412
8/7/2022,Trimble,Kentucky,21223,2333,42,2375
8/7/2022,Union,Kentucky,21225,4713,57,4770
8/7/2022,Warren,Kentucky,21227,46939,388,47327
8/7/2022,Washington,Kentucky,21229,4348,62,4410
8/7/2022,Wayne,Kentucky,21231,6608,93,6701
8/7/2022,Webster,Kentucky,21233,4246,50,4296
8/7/2022,Whitley,Kentucky,21235,14841,213,15054
8/7/2022,Wolfe,Kentucky,21237,2817,29,2846
8/7/2022,Woodford,Kentucky,21239,7941,53,7994
8/7/2022,Acadia,Louisiana,22001,17403,297,17700
8/7/2022,Allen,Louisiana,22003,8436,142,8578
8/7/2022,Ascension,Louisiana,22005,38392,297,38689
8/7/2022,Assumption,Louisiana,22007,6164,70,6234
8/7/2022,Avoyelles,Louisiana,22009,12957,214,13171
8/7/2022,Weston,Wyoming,56045,1747,20,1767
8/7/2022,Washakie,Wyoming,56043,2573,46,2619
8/7/2022,Uinta,Wyoming,56041,5991,39,6030
8/7/2022,Teton,Wyoming,56039,11304,16,11320
8/7/2022,Sweetwater,Wyoming,56037,11854,128,11982
8/7/2022,Sublette,Wyoming,56035,2110,27,2137
8/7/2022,Sheridan,Wyoming,56033,8952,81,9033
8/7/2022,Platte,Wyoming,56031,2092,42,2134
8/7/2022,Beauregard,Louisiana,22011,10190,143,10333
8/7/2022,Bienville,Louisiana,22013,4409,113,4522
8/7/2022,Bossier,Louisiana,22015,43886,504,44390
8/7/2022,Caddo,Louisiana,22017,76659,1169,77828
8/7/2022,Calcasieu,Louisiana,22019,60587,715,61302
8/7/2022,Caldwell,Louisiana,22021,3960,55,4015
8/7/2022,Cameron,Louisiana,22023,1285,8,1293
8/7/2022,Park,Wyoming,56029,7266,146,7412
8/7/2022,Catahoula,Louisiana,22025,2891,58,2949
8/7/2022,Claiborne,Louisiana,22027,3622,79,3701
8/7/2022,Concordia,Louisiana,22029,5628,89,5717
8/7/2022,De Soto,Louisiana,22031,8482,137,8619
8/7/2022,East Baton Rouge,Louisiana,22033,124065,1372,125437
8/7/2022,East Carroll,Louisiana,22035,2815,38,2853
8/7/2022,East Feliciana,Louisiana,22037,7677,171,7848
8/7/2022,Niobrara,Wyoming,56027,745,10,755
8/7/2022,Natrona,Wyoming,56025,23932,280,24212
8/7/2022,Lincoln,Wyoming,56023,4540,32,4572
8/7/2022,Laramie,Wyoming,56021,29073,297,29370
8/7/2022,Evangeline,Louisiana,22039,9347,161,9508
8/7/2022,Franklin,Louisiana,22041,7999,181,8180
8/7/2022,Grant,Louisiana,22043,6479,95,6574
8/7/2022,Iberia,Louisiana,22045,21577,268,21845
8/7/2022,Iberville,Louisiana,22047,10397,153,10550
8/7/2022,Johnson,Wyoming,56019,2082,20,2102
8/7/2022,Hot Springs,Wyoming,56017,1300,18,1318
8/7/2022,Goshen,Wyoming,56015,4256,57,4313
8/7/2022,Fremont,Wyoming,56013,15368,196,15564
8/7/2022,Crook,Wyoming,56011,1445,29,1474
8/7/2022,Converse,Wyoming,56009,3351,55,3406
8/7/2022,Carbon,Wyoming,56007,4798,53,4851
8/7/2022,Campbell,Wyoming,56005,12902,150,13052
8/7/2022,Big Horn,Wyoming,56003,2832,63,2895
8/7/2022,Jackson,Louisiana,22049,4960,77,5037
8/7/2022,Jefferson,Louisiana,22051,129154,1371,130525
8/7/2022,Jefferson Davis,Louisiana,22053,7609,163,7772
8/7/2022,Lafayette,Louisiana,22055,69604,510,70114
8/7/2022,Lafourche,Louisiana,22057,31204,385,31589
8/7/2022,LaSalle,Louisiana,22059,4680,63,4743
8/7/2022,Lincoln,Louisiana,22061,13633,149,13782
8/7/2022,Livingston,Louisiana,22063,40286,475,40761
8/7/2022,Albany,Wyoming,56001,10809,51,10860
8/7/2022,Wood,Wisconsin,55141,23835,242,24077
8/7/2022,Winnebago,Wisconsin,55139,57174,396,57570
8/7/2022,Waushara,Wisconsin,55137,6944,87,7031
8/7/2022,Waupaca,Wisconsin,55135,14742,256,14998
8/7/2022,Waukesha,Wisconsin,55133,126548,1137,127685
8/7/2022,Washington,Wisconsin,55131,42238,348,42586
8/7/2022,Washburn,Wisconsin,55129,4483,47,4530
8/7/2022,Madison,Louisiana,22065,3562,58,3620
8/7/2022,Morehouse,Louisiana,22067,7764,135,7899
8/7/2022,Natchitoches,Louisiana,22069,11606,174,11780
8/7/2022,Orleans,Louisiana,22071,102669,1143,103812
8/7/2022,Ouachita,Louisiana,22073,56312,767,57079
8/7/2022,Plaquemines,Louisiana,22075,7171,46,7217
8/7/2022,Pointe Coupee,Louisiana,22077,7096,93,7189
8/7/2022,Rapides,Louisiana,22079,36425,586,37011
8/7/2022,Walworth,Wisconsin,55127,29458,290,29748
8/7/2022,Vilas,Wisconsin,55125,5824,91,5915
8/7/2022,Vernon,Wisconsin,55123,6814,104,6918
8/7/2022,Trempealeau,Wisconsin,55121,9056,67,9123
8/7/2022,Taylor,Wisconsin,55119,5184,73,5257
8/7/2022,St. Croix,Wisconsin,55109,27677,153,27830
8/7/2022,Sheboygan,Wisconsin,55117,35875,337,36212
8/7/2022,Shawano,Wisconsin,55115,12671,155,12826
8/7/2022,Sawyer,Wisconsin,55113,5238,63,5301
8/7/2022,Sauk,Wisconsin,55111,18244,139,18383
8/7/2022,Rusk,Wisconsin,55107,3763,59,3822
8/7/2022,Rock,Wisconsin,55105,48555,405,48960
8/7/2022,Red River,Louisiana,22081,2313,54,2367
8/7/2022,Richland,Louisiana,22083,7628,102,7730
8/7/2022,Sabine,Louisiana,22085,7159,115,7274
8/7/2022,St. Bernard,Louisiana,22087,12805,114,12919
8/7/2022,St. Charles,Louisiana,22089,15585,145,15730
8/7/2022,St. Helena,Louisiana,22091,2057,25,2082
8/7/2022,St. James,Louisiana,22093,6607,76,6683
8/7/2022,St. John the Baptist,Louisiana,22095,11966,184,12150
8/7/2022,St. Landry,Louisiana,22097,24809,418,25227
8/7/2022,Richland,Wisconsin,55103,4391,51,4442
8/7/2022,Racine,Wisconsin,55101,62958,708,63666
8/7/2022,Price,Wisconsin,55099,3552,34,3586
8/7/2022,Portage,Wisconsin,55097,20275,164,20439
8/7/2022,Polk,Wisconsin,55095,13556,123,13679
8/7/2022,Pierce,Wisconsin,55093,12473,75,12548
8/7/2022,Pepin,Wisconsin,55091,2123,18,2141
8/7/2022,Ozaukee,Wisconsin,55089,25276,192,25468
8/7/2022,Outagamie,Wisconsin,55087,58997,419,59416
8/7/2022,Oneida,Wisconsin,55085,9627,140,9767
8/7/2022,Oconto,Wisconsin,55083,12159,125,12284
8/7/2022,St. Martin,Louisiana,22099,13964,192,14156
8/7/2022,St. Mary,Louisiana,22101,13890,270,14160
8/7/2022,St. Tammany,Louisiana,22103,81761,874,82635
8/7/2022,Tangipahoa,Louisiana,22105,39305,619,39924
8/7/2022,Tensas,Louisiana,22107,1130,12,1142
8/7/2022,Terrebonne,Louisiana,22109,35187,426,35613
8/7/2022,Union,Louisiana,22111,7838,139,7977
8/7/2022,Unknown,Louisiana,,1102,0,1102
8/7/2022,Vermilion,Louisiana,22113,17078,230,17308
8/7/2022,Vernon,Louisiana,22115,10763,192,10955
8/7/2022,Washington,Louisiana,22117,14509,259,14768
8/7/2022,Webster,Louisiana,22119,12731,188,12919
8/7/2022,Monroe,Wisconsin,55081,13247,100,13347
8/7/2022,Milwaukee,Wisconsin,55079,304407,2344,306751
8/7/2022,West Baton Rouge,Louisiana,22121,8130,93,8223
8/7/2022,West Carroll,Louisiana,22123,4148,69,4217
8/7/2022,West Feliciana,Louisiana,22125,3042,48,3090
8/7/2022,Winn,Louisiana,22127,4915,65,4980
8/7/2022,Menominee,Wisconsin,55078,2076,15,2091
8/7/2022,Marquette,Wisconsin,55077,4226,62,4288
8/7/2022,Marinette,Wisconsin,55075,12682,133,12815
8/7/2022,Marathon,Wisconsin,55073,44029,509,44538
8/7/2022,Manitowoc,Wisconsin,55071,22438,194,22632
8/7/2022,Lincoln,Wisconsin,55069,7936,153,8089
8/7/2022,Langlade,Wisconsin,55067,5825,92,5917
8/7/2022,Lafayette,Wisconsin,55065,4016,29,4045
8/7/2022,La Crosse,Wisconsin,55063,39267,192,39459
8/7/2022,Kewaunee,Wisconsin,55061,6247,60,6307
8/7/2022,Androscoggin,Maine,23001,24881,297,25178
8/7/2022,Aroostook,Maine,23003,15846,181,16027
8/7/2022,Cumberland,Maine,23005,58294,397,58691
8/7/2022,Franklin,Maine,23007,6496,65,6561
8/7/2022,Hancock,Maine,23009,8819,93,8912
8/7/2022,Kennebec,Maine,23011,26527,256,26783
8/7/2022,Kenosha,Wisconsin,55059,49611,653,50264
8/7/2022,Juneau,Wisconsin,55057,8441,70,8511
8/7/2022,Jefferson,Wisconsin,55055,23884,248,24132
8/7/2022,Jackson,Wisconsin,55053,6158,43,6201
8/7/2022,Iron,Wisconsin,55051,1600,48,1648
8/7/2022,Iowa,Wisconsin,55049,6065,30,6095
8/7/2022,Green Lake,Wisconsin,55047,5689,65,5754
8/7/2022,Green,Wisconsin,55045,10308,55,10363
8/7/2022,Grant,Wisconsin,55043,14029,151,14180
8/7/2022,Knox,Maine,23013,7048,41,7089
8/7/2022,Lincoln,Maine,23015,6096,40,6136
8/7/2022,Oxford,Maine,23017,12810,153,12963
8/7/2022,Penobscot,Maine,23019,32228,351,32579
8/7/2022,Piscataquis,Maine,23021,3345,34,3379
8/7/2022,Forest,Wisconsin,55041,2979,52,3031
8/7/2022,Fond du Lac,Wisconsin,55039,34920,289,35209
8/7/2022,Florence,Wisconsin,55037,1171,17,1188
8/7/2022,Eau Claire,Wisconsin,55035,33541,195,33736
8/7/2022,Dunn,Wisconsin,55033,14440,76,14516
8/7/2022,Douglas,Wisconsin,55031,13051,81,13132
8/7/2022,Door,Wisconsin,55029,7786,73,7859
8/7/2022,Dodge,Wisconsin,55027,29252,343,29595
8/7/2022,Dane,Wisconsin,55025,157137,546,157683
8/7/2022,Sagadahoc,Maine,23023,6071,37,6108
8/7/2022,Somerset,Maine,23025,10983,115,11098
8/7/2022,Unknown,Maine,,5,0,5
8/7/2022,Waldo,Maine,23027,7080,63,7143
8/7/2022,Washington,Maine,23029,4947,60,5007
8/7/2022,York,Maine,23031,45983,310,46293
8/7/2022,Crawford,Wisconsin,55023,4663,31,4694
8/7/2022,Columbia,Wisconsin,55021,17459,133,17592
8/7/2022,Clark,Wisconsin,55019,8212,123,8335
8/7/2022,Chippewa,Wisconsin,55017,20207,195,20402
8/7/2022,Calumet,Wisconsin,55015,15607,125,15732
8/7/2022,Burnett,Wisconsin,55013,4488,45,4533
8/7/2022,Buffalo,Wisconsin,55011,3834,12,3846
8/7/2022,Brown,Wisconsin,55009,92740,574,93314
8/7/2022,Bayfield,Wisconsin,55007,3934,42,3976
8/7/2022,Barron,Wisconsin,55005,14641,147,14788
8/7/2022,Ashland,Wisconsin,55003,3754,39,3793
8/7/2022,Adams,Wisconsin,55001,5177,64,5241
8/7/2022,Allegany,Maryland,24001,18779,368,19147
8/7/2022,Anne Arundel,Maryland,24003,105153,1140,106293
8/7/2022,Baltimore,Maryland,24005,151574,2572,154146
8/7/2022,Baltimore city,Maryland,24510,130723,1840,132563
8/7/2022,Calvert,Maryland,24009,12881,152,13033
8/7/2022,Caroline,Maryland,24011,6594,81,6675
8/7/2022,Carroll,Maryland,24013,24596,419,25015
8/7/2022,Cecil,Maryland,24015,17669,267,17936
8/7/2022,Wyoming,West Virginia,54109,7963,125,8088
8/7/2022,Wood,West Virginia,54107,24695,356,25051
8/7/2022,Wirt,West Virginia,54105,1562,25,1587
8/7/2022,Wetzel,West Virginia,54103,4833,88,4921
8/7/2022,Webster,West Virginia,54101,2555,34,2589
8/7/2022,Wayne,West Virginia,54099,10697,130,10827
8/7/2022,Upshur,West Virginia,54097,7761,99,7860
8/7/2022,Charles,Maryland,24017,33319,365,33684
8/7/2022,Dorchester,Maryland,24019,8495,110,8605
8/7/2022,Frederick,Maryland,24021,51914,541,52455
8/7/2022,Garrett,Maryland,24023,6260,116,6376
8/7/2022,Harford,Maryland,24025,43709,599,44308
8/7/2022,Tyler,West Virginia,54095,2389,32,2421
8/7/2022,Tucker,West Virginia,54093,2154,38,2192
8/7/2022,Taylor,West Virginia,54091,5130,73,5203
8/7/2022,Summers,West Virginia,54089,3183,56,3239
8/7/2022,Roane,West Virginia,54087,3720,41,3761
8/7/2022,Ritchie,West Virginia,54085,2677,31,2708
8/7/2022,Randolph,West Virginia,54083,10433,92,10525
8/7/2022,Raleigh,West Virginia,54081,26259,370,26629
8/7/2022,Putnam,West Virginia,54079,18741,190,18931
8/7/2022,Howard,Maryland,24027,54906,390,55296
8/7/2022,Kent,Maryland,24029,3493,72,3565
8/7/2022,Preston,West Virginia,54077,9994,140,10134
8/7/2022,Pocahontas,West Virginia,54075,2231,32,2263
8/7/2022,Pleasants,West Virginia,54073,2251,38,2289
8/7/2022,Montgomery,Maryland,24031,211965,2118,214083
8/7/2022,Prince George's,Maryland,24033,198066,2220,200286
8/7/2022,Queen Anne's,Maryland,24035,7902,117,8019
8/7/2022,Somerset,Maryland,24039,5607,76,5683
8/7/2022,St. Mary's,Maryland,24037,21479,227,21706
8/7/2022,Talbot,Maryland,24041,6282,92,6374
8/7/2022,Unknown,Maryland,,0,31,31
8/7/2022,Washington,Maryland,24043,37623,599,38222
8/7/2022,Wicomico,Maryland,24045,21976,337,22313
8/7/2022,Pendleton,West Virginia,54071,2093,22,2115
8/7/2022,Ohio,West Virginia,54069,12470,183,12653
8/7/2022,Nicholas,West Virginia,54067,8304,100,8404
8/7/2022,Morgan,West Virginia,54065,4579,70,4649
8/7/2022,Monroe,West Virginia,54063,4806,46,4852
8/7/2022,Monongalia,West Virginia,54061,27950,200,28150
8/7/2022,Mingo,West Virginia,54059,8696,126,8822
8/7/2022,Mineral,West Virginia,54057,8801,161,8962
8/7/2022,Mercer,West Virginia,54055,19571,273,19844
8/7/2022,McDowell,West Virginia,54047,6422,77,6499
8/7/2022,Worcester,Maryland,24047,9714,162,9876
8/7/2022,Barnstable,Massachusetts,25001,42093,624,42717
8/7/2022,Berkshire,Massachusetts,25003,30023,407,30430
8/7/2022,Bristol,Massachusetts,25005,165177,2232,167409
8/7/2022,Dukes,Massachusetts,25007,4032,0,4032
8/7/2022,Essex,Massachusetts,25009,230916,2851,233767
8/7/2022,Franklin,Massachusetts,25011,12695,155,12850
8/7/2022,Hampden,Massachusetts,25013,151178,1876,153054
8/7/2022,Hampshire,Massachusetts,25015,34680,373,35053
8/7/2022,Mason,West Virginia,54053,7630,99,7729
8/7/2022,Vinton,Ohio,39163,3197,56,3253
8/7/2022,Marshall,West Virginia,54051,10077,160,10237
8/7/2022,Marion,West Virginia,54049,17297,185,17482
8/7/2022,Logan,West Virginia,54045,11020,190,11210
8/7/2022,Lincoln,West Virginia,54043,6184,84,6268
8/7/2022,Lewis,West Virginia,54041,6121,91,6212
8/7/2022,Kanawha,West Virginia,54039,53014,763,53777
8/7/2022,Jefferson,West Virginia,54037,16051,137,16188
8/7/2022,Middlesex,Massachusetts,25017,391272,4191,395463
8/7/2022,Nantucket,Massachusetts,25019,3661,0,3661
8/7/2022,Warren,Ohio,39165,64332,594,64926
8/7/2022,Norfolk,Massachusetts,25021,155619,1992,157611
8/7/2022,Plymouth,Massachusetts,25023,129184,1751,130935
8/7/2022,Suffolk,Massachusetts,25025,244418,2058,246476
8/7/2022,Unknown,Massachusetts,,166135,25,166160
8/7/2022,Worcester,Massachusetts,25027,216420,2689,219109
8/7/2022,Jackson,West Virginia,54035,7686,140,7826
8/7/2022,Alcona,Michigan,26001,1803,72,1875
8/7/2022,Alger,Michigan,26003,2044,15,2059
8/7/2022,Allegan,Michigan,26005,29430,368,29798
8/7/2022,Alpena,Michigan,26007,5980,143,6123
8/7/2022,Antrim,Michigan,26009,4806,70,4876
8/7/2022,Arenac,Michigan,26011,3485,72,3557
8/7/2022,Baraga,Michigan,26013,2433,56,2489
8/7/2022,Barry,Michigan,26015,15432,177,15609
8/7/2022,Bay,Michigan,26017,29122,607,29729
8/7/2022,Benzie,Michigan,26019,3783,73,3856
8/7/2022,Berrien,Michigan,26021,37896,592,38488
8/7/2022,Branch,Michigan,26023,12952,215,13167
8/7/2022,Harrison,West Virginia,54033,22686,262,22948
8/7/2022,Hardy,West Virginia,54031,4677,50,4727
8/7/2022,Calhoun,Michigan,26025,37549,606,38155
8/7/2022,Cass,Michigan,26027,11842,150,11992
8/7/2022,Charlevoix,Michigan,26029,5343,61,5404
8/7/2022,Cheboygan,Michigan,26031,5215,111,5326
8/7/2022,Chippewa,Michigan,26033,12408,123,12531
8/7/2022,Clare,Michigan,26035,7297,160,7457
8/7/2022,Clinton,Michigan,26037,23983,213,24196
8/7/2022,Hancock,West Virginia,54029,7445,143,7588
8/7/2022,Hampshire,West Virginia,54027,6466,74,6540
8/7/2022,Crawford,Michigan,26039,2852,34,2886
8/7/2022,Delta,Michigan,26041,10891,164,11055
8/7/2022,Dickinson,Michigan,26043,8047,115,8162
8/7/2022,Eaton,Michigan,26045,30141,424,30565
8/7/2022,Emmet,Michigan,26047,6993,94,7087
8/7/2022,Genesee,Michigan,26049,111628,1809,113437
8/7/2022,Gladwin,Michigan,26051,5997,119,6116
8/7/2022,Gogebic,Michigan,26053,3728,72,3800
8/7/2022,Grand Traverse,Michigan,26055,19420,247,19667
8/7/2022,Greenbrier,West Virginia,54025,10950,166,11116
8/7/2022,Grant,West Virginia,54023,4086,57,4143
8/7/2022,Gilmer,West Virginia,54021,2299,21,2320
8/7/2022,Fayette,West Virginia,54019,14712,212,14924
8/7/2022,Doddridge,West Virginia,54017,2282,18,2300
8/7/2022,Clay,West Virginia,54015,2506,47,2553
8/7/2022,Gratiot,Michigan,26057,14562,196,14758
8/7/2022,Hillsdale,Michigan,26059,11305,207,11512
8/7/2022,Houghton,Michigan,26061,8667,103,8770
8/7/2022,Huron,Michigan,26063,8659,149,8808
8/7/2022,Ingham,Michigan,26065,72840,804,73644
8/7/2022,Ionia,Michigan,26067,20820,188,21008
8/7/2022,Calhoun,West Virginia,54013,2059,15,2074
8/7/2022,Cabell,West Virginia,54011,30675,396,31071
8/7/2022,Iosco,Michigan,26069,5185,151,5336
8/7/2022,Iron,Michigan,26071,2941,88,3029
8/7/2022,Isabella,Michigan,26073,16658,222,16880
8/7/2022,Jackson,Michigan,26075,48883,619,49502
8/7/2022,Kalamazoo,Michigan,26077,67190,702,67892
8/7/2022,Kalkaska,Michigan,26079,4031,62,4093
8/7/2022,Kent,Michigan,26081,183400,1602,185002
8/7/2022,Keweenaw,Michigan,26083,593,13,606
8/7/2022,Lake,Michigan,26085,2088,39,2127
8/7/2022,Lapeer,Michigan,26087,22225,432,22657
8/7/2022,Leelanau,Michigan,26089,4020,61,4081
8/7/2022,Lenawee,Michigan,26091,28498,337,28835
8/7/2022,Livingston,Michigan,26093,51365,477,51842
8/7/2022,Luce,Michigan,26095,2412,17,2429
8/7/2022,Mackinac,Michigan,26097,2696,31,2727
8/7/2022,Brooke,West Virginia,54009,5541,106,5647
8/7/2022,Braxton,West Virginia,54007,4487,47,4534
8/7/2022,Macomb,Michigan,26099,261282,4121,265403
8/7/2022,Manistee,Michigan,26101,4891,97,4988
8/7/2022,Marquette,Michigan,26103,17946,143,18089
8/7/2022,Mason,Michigan,26105,7448,96,7544
8/7/2022,Boone,West Virginia,54005,7486,83,7569
8/7/2022,Berkeley,West Virginia,54003,39556,316,39872
8/7/2022,Mecosta,Michigan,26107,9355,115,9470
8/7/2022,Barbour,West Virginia,54001,5362,74,5436
8/7/2022,Yakima,Washington,53077,79745,811,80556
8/7/2022,Whitman,Washington,53075,9503,96,9599
8/7/2022,Whatcom,Washington,53073,45039,321,45360
8/7/2022,Walla Walla,Washington,53071,17993,159,18152
8/7/2022,Wahkiakum,Washington,53069,590,8,598
8/7/2022,Thurston,Washington,53067,56993,451,57444
8/7/2022,Stevens,Washington,53065,8994,155,9149
8/7/2022,Spokane,Washington,53063,139406,1476,140882
8/7/2022,Snohomish,Washington,53061,184142,1235,185377
8/7/2022,Skamania,Washington,53059,1682,13,1695
8/7/2022,Skagit,Washington,53057,25640,215,25855
8/7/2022,Menominee,Michigan,26109,6127,74,6201
8/7/2022,Midland,Michigan,26111,20966,235,21201
8/7/2022,Missaukee,Michigan,26113,3171,63,3234
8/7/2022,Monroe,Michigan,26115,42523,494,43017
8/7/2022,Montcalm,Michigan,26117,18280,224,18504
8/7/2022,Montmorency,Michigan,26119,1824,49,1873
8/7/2022,Muskegon,Michigan,26121,45622,665,46287
8/7/2022,Newaygo,Michigan,26123,12334,161,12495
8/7/2022,Oakland,Michigan,26125,334623,4015,338638
8/7/2022,Oceana,Michigan,26127,6966,92,7058
8/7/2022,Ogemaw,Michigan,26129,4587,109,4696
8/7/2022,Ontonagon,Michigan,26131,1127,40,1167
8/7/2022,Osceola,Michigan,26133,5436,85,5521
8/7/2022,San Juan,Washington,53055,1758,2,1760
8/7/2022,Pierce,Washington,53053,222787,1477,224264
8/7/2022,Pend Oreille,Washington,53051,2695,37,2732
8/7/2022,Pacific,Washington,53049,4312,65,4377
8/7/2022,Okanogan,Washington,53047,9473,130,9603
8/7/2022,Mason,Washington,53045,14150,155,14305
8/7/2022,Oscoda,Michigan,26135,1538,58,1596
8/7/2022,Otsego,Michigan,26137,6168,104,6272
8/7/2022,Lincoln,Washington,53043,2460,29,2489
8/7/2022,Ottawa,Michigan,26139,81139,815,81954
8/7/2022,Presque Isle,Michigan,26141,2209,61,2270
8/7/2022,Lewis,Washington,53041,19445,276,19721
8/7/2022,Klickitat,Washington,53039,4013,51,4064
8/7/2022,Kittitas,Washington,53037,9621,79,9700
8/7/2022,Kitsap,Washington,53035,47058,372,47430
8/7/2022,King,Washington,53033,495203,3015,498218
8/7/2022,Jefferson,Washington,53031,4027,30,4057
8/7/2022,Island,Washington,53029,12180,91,12271
8/7/2022,Grays Harbor,Washington,53027,18776,211,18987
8/7/2022,Grant,Washington,53025,29624,263,29887
8/7/2022,Garfield,Washington,53023,433,7,440
8/7/2022,Roscommon,Michigan,26143,5044,122,5166
8/7/2022,Saginaw,Michigan,26145,55398,982,56380
8/7/2022,Sanilac,Michigan,26151,9291,203,9494
8/7/2022,Schoolcraft,Michigan,26153,1936,16,1952
8/7/2022,Shiawassee,Michigan,26155,19419,233,19652
8/7/2022,St. Clair,Michigan,26147,44335,850,45185
8/7/2022,St. Joseph,Michigan,26149,14536,212,14748
8/7/2022,Tuscola,Michigan,26157,14054,289,14343
8/7/2022,Unknown,Michigan,,20227,83,20310
8/7/2022,Franklin,Washington,53021,34890,216,35106
8/7/2022,Ferry,Washington,53019,1590,30,1620
8/7/2022,Douglas,Washington,53017,12283,75,12358
8/7/2022,Cowlitz,Washington,53015,25334,370,25704
8/7/2022,Columbia,Washington,53013,668,16,684
8/7/2022,Clark,Washington,53011,102313,885,103198
8/7/2022,Clallam,Washington,53009,14115,162,14277
8/7/2022,Chelan,Washington,53007,22343,174,22517
8/7/2022,Benton,Washington,53005,57609,500,58109
8/7/2022,Asotin,Washington,53003,4941,72,5013
8/7/2022,Adams,Washington,53001,5345,39,5384
8/7/2022,Van Buren,Michigan,26159,18643,285,18928
8/7/2022,Washtenaw,Michigan,26161,95346,555,95901
8/7/2022,Wayne,Michigan,26163,459418,8213,467631
8/7/2022,Wexford,Michigan,26165,7738,113,7851
8/7/2022,Aitkin,Minnesota,27001,3280,63,3343
8/7/2022,Anoka,Minnesota,27003,108058,815,108873
8/7/2022,Becker,Minnesota,27005,9507,98,9605
8/7/2022,St. Thomas,Virgin Islands,78030,9754,63,9817
8/7/2022,St. John,Virgin Islands,78020,986,5,991
8/7/2022,St. Croix,Virgin Islands,78010,11035,52,11087
8/7/2022,York,Virginia,51199,11761,114,11875
8/7/2022,Wythe,Virginia,51197,8370,152,8522
8/7/2022,Beltrami,Minnesota,27007,12841,129,12970
8/7/2022,Benton,Minnesota,27009,15350,180,15530
8/7/2022,Big Stone,Minnesota,27011,1512,9,1521
8/7/2022,Blue Earth,Minnesota,27013,19502,105,19607
8/7/2022,Brown,Minnesota,27015,7075,81,7156
8/7/2022,Carlton,Minnesota,27017,10085,104,10189
8/7/2022,Carver,Minnesota,27019,29485,122,29607
8/7/2022,Cass,Minnesota,27021,7675,84,7759
8/7/2022,Chippewa,Minnesota,27023,3351,49,3400
8/7/2022,Wise,Virginia,51195,11706,203,11909
8/7/2022,Winchester city,Virginia,51840,7052,82,7134
8/7/2022,Williamsburg city,Virginia,51830,2009,23,2032
8/7/2022,Westmoreland,Virginia,51193,3594,55,3649
8/7/2022,Waynesboro city,Virginia,51820,6569,69,6638
8/7/2022,Washington,Virginia,51191,15454,221,15675
8/7/2022,Warren,Virginia,51187,9674,161,9835
8/7/2022,Virginia Beach city,Virginia,51810,102672,868,103540
8/7/2022,Tazewell,Virginia,51185,11485,182,11667
8/7/2022,Sussex,Virginia,51183,2653,44,2697
8/7/2022,Surry,Virginia,51181,1224,20,1244
8/7/2022,Chisago,Minnesota,27025,15786,121,15907
8/7/2022,Clay,Minnesota,27027,21431,129,21560
8/7/2022,Clearwater,Minnesota,27029,2239,31,2270
8/7/2022,Cook,Minnesota,27031,682,4,686
8/7/2022,Cottonwood,Minnesota,27033,3415,41,3456
8/7/2022,Crow Wing,Minnesota,27035,17401,172,17573
8/7/2022,Dakota,Minnesota,27037,123700,807,124507
8/7/2022,Dodge,Minnesota,27039,6230,22,6252
8/7/2022,Douglas,Minnesota,27041,11869,120,11989
8/7/2022,Faribault,Minnesota,27043,4091,54,4145
8/7/2022,Fillmore,Minnesota,27045,5246,25,5271
8/7/2022,Suffolk city,Virginia,51800,21570,313,21883
8/7/2022,Staunton city,Virginia,51790,6553,119,6672
8/7/2022,Stafford,Virginia,51179,36074,181,36255
8/7/2022,Spotsylvania,Virginia,51177,31173,308,31481
8/7/2022,Southampton,Virginia,51175,3938,96,4034
8/7/2022,Smyth,Virginia,51173,9871,177,10048
8/7/2022,Shenandoah,Virginia,51171,11882,233,12115
8/7/2022,Scott,Virginia,51169,6334,115,6449
8/7/2022,Salem city,Virginia,51775,6371,100,6471
8/7/2022,Russell,Virginia,51167,7545,117,7662
8/7/2022,Freeborn,Minnesota,27047,9651,78,9729
8/7/2022,Goodhue,Minnesota,27049,14473,146,14619
8/7/2022,Grant,Minnesota,27051,1584,12,1596
8/7/2022,Hennepin,Minnesota,27053,346160,2660,348820
8/7/2022,Houston,Minnesota,27055,5004,20,5024
8/7/2022,Hubbard,Minnesota,27057,5387,60,5447
8/7/2022,Isanti,Minnesota,27059,10827,120,10947
8/7/2022,Itasca,Minnesota,27061,12217,151,12368
8/7/2022,Jackson,Minnesota,27063,2315,17,2332
8/7/2022,Kanabec,Minnesota,27065,3852,57,3909
8/7/2022,Kandiyohi,Minnesota,27067,14319,143,14462
8/7/2022,Kittson,Minnesota,27069,1116,29,1145
8/7/2022,Rockingham,Virginia,51165,15897,236,16133
8/7/2022,Rockbridge,Virginia,51163,3765,82,3847
8/7/2022,Roanoke city,Virginia,51770,24305,382,24687
8/7/2022,Roanoke,Virginia,51161,24275,290,24565
8/7/2022,Richmond city,Virginia,51760,53333,521,53854
8/7/2022,Richmond,Virginia,51159,2668,25,2693
8/7/2022,Rappahannock,Virginia,51157,1153,10,1163
8/7/2022,Radford city,Virginia,51750,5511,54,5565
8/7/2022,Pulaski,Virginia,51155,8215,143,8358
8/7/2022,Prince William,Virginia,51153,111392,763,112155
8/7/2022,Prince George,Virginia,51149,9987,81,10068
8/7/2022,Koochiching,Minnesota,27071,3200,39,3239
8/7/2022,Lac qui Parle,Minnesota,27073,1901,29,1930
8/7/2022,Lake,Minnesota,27075,2343,30,2373
8/7/2022,Lake of the Woods,Minnesota,27077,835,6,841
8/7/2022,Le Sueur,Minnesota,27079,6882,51,6933
8/7/2022,Lincoln,Minnesota,27081,1295,6,1301
8/7/2022,Lyon,Minnesota,27083,7456,74,7530
8/7/2022,Mahnomen,Minnesota,27087,1918,18,1936
8/7/2022,Marshall,Minnesota,27089,2260,24,2284
8/7/2022,Martin,Minnesota,27091,6032,65,6097
8/7/2022,Prince Edward,Virginia,51147,5639,77,5716
8/7/2022,Powhatan,Virginia,51145,5764,63,5827
8/7/2022,Portsmouth city,Virginia,51740,23467,343,23810
8/7/2022,Poquoson city,Virginia,51735,2625,30,2655
8/7/2022,Pittsylvania,Virginia,51143,16032,213,16245
8/7/2022,Petersburg city,Virginia,51730,9163,141,9304
8/7/2022,Patrick,Virginia,51141,4116,97,4213
8/7/2022,Page,Virginia,51139,6035,124,6159
8/7/2022,Orange,Virginia,51137,7773,93,7866
8/7/2022,McLeod,Minnesota,27085,11585,112,11697
8/7/2022,Meeker,Minnesota,27093,6404,78,6482
8/7/2022,Mille Lacs,Minnesota,27095,7726,118,7844
8/7/2022,Morrison,Minnesota,27097,9924,108,10032
8/7/2022,Mower,Minnesota,27099,12712,75,12787
8/7/2022,Nottoway,Virginia,51135,4841,96,4937
8/7/2022,Norton city,Virginia,51720,1483,22,1505
8/7/2022,Northumberland,Virginia,51133,2390,43,2433
8/7/2022,Northampton,Virginia,51131,2524,68,2592
8/7/2022,Norfolk city,Virginia,51710,48007,489,48496
8/7/2022,Murray,Minnesota,27101,2156,20,2176
8/7/2022,Nicollet,Minnesota,27103,8917,69,8986
8/7/2022,Nobles,Minnesota,27105,7375,61,7436
8/7/2022,Newport News city,Virginia,51700,42568,415,42983
8/7/2022,Norman,Minnesota,27107,1612,14,1626
8/7/2022,Olmsted,Minnesota,27109,47895,195,48090
8/7/2022,Otter Tail,Minnesota,27111,14635,172,14807
8/7/2022,Pennington,Minnesota,27113,3876,41,3917
8/7/2022,Pine,Minnesota,27115,7694,68,7762
8/7/2022,Pipestone,Minnesota,27117,2102,34,2136
8/7/2022,Polk,Minnesota,27119,9551,111,9662
8/7/2022,Pope,Minnesota,27121,3441,20,3461
8/7/2022,Ramsey,Minnesota,27123,142148,1397,143545
8/7/2022,New Kent,Virginia,51127,5287,38,5325
8/7/2022,Nelson,Virginia,51125,2897,36,2933
8/7/2022,Montgomery,Virginia,51121,21592,158,21750
8/7/2022,Middlesex,Virginia,51119,2115,48,2163
8/7/2022,Mecklenburg,Virginia,51117,6865,131,6996
8/7/2022,Red Lake,Minnesota,27125,978,13,991
8/7/2022,Redwood,Minnesota,27127,4217,54,4271
8/7/2022,Mathews,Virginia,51115,1683,27,1710
8/7/2022,Renville,Minnesota,27129,4060,58,4118
8/7/2022,Rice,Minnesota,27131,19296,190,19486
8/7/2022,Rock,Minnesota,27133,2493,35,2528
8/7/2022,Roseau,Minnesota,27135,4702,45,4747
8/7/2022,Martinsville city,Virginia,51690,3782,124,3906
8/7/2022,Manassas Park city,Virginia,51685,4296,28,4324
8/7/2022,Manassas city,Virginia,51683,10377,73,10450
8/7/2022,Madison,Virginia,51113,2700,43,2743
8/7/2022,Lynchburg city,Virginia,51680,21395,283,21678
8/7/2022,Lunenburg,Virginia,51111,2842,39,2881
8/7/2022,Louisa,Virginia,51109,7659,85,7744
8/7/2022,Loudoun,Virginia,51107,84509,402,84911
8/7/2022,Scott,Minnesota,27139,44235,270,44505
8/7/2022,Sherburne,Minnesota,27141,29129,186,29315
8/7/2022,Sibley,Minnesota,27143,3813,26,3839
8/7/2022,Stearns,Minnesota,27145,55272,381,55653
8/7/2022,Steele,Minnesota,27147,11146,63,11209
8/7/2022,Stevens,Minnesota,27149,2935,14,2949
8/7/2022,St. Louis,Minnesota,27137,53673,558,54231
8/7/2022,Swift,Minnesota,27151,2438,33,2471
8/7/2022,Todd,Minnesota,27153,7435,62,7497
8/7/2022,Lexington city,Virginia,51678,2970,40,3010
8/7/2022,Lee,Virginia,51105,6678,94,6772
8/7/2022,Lancaster,Virginia,51103,2053,33,2086
8/7/2022,King William,Virginia,51101,4138,46,4184
8/7/2022,King George,Virginia,51099,5904,45,5949
8/7/2022,King and Queen,Virginia,51097,1268,12,1280
8/7/2022,James City,Virginia,51095,18200,127,18327
8/7/2022,Isle of Wight,Virginia,51093,8174,120,8294
8/7/2022,Hopewell city,Virginia,51670,6861,119,6980
8/7/2022,Highland,Virginia,51091,412,7,419
8/7/2022,Henry,Virginia,51089,13844,277,14121
8/7/2022,Henrico,Virginia,51087,78088,978,79066
8/7/2022,Harrisonburg city,Virginia,51660,14460,167,14627
8/7/2022,Traverse,Minnesota,27155,912,11,923
8/7/2022,Unknown,Minnesota,,770,342,1112
8/7/2022,Wabasha,Minnesota,27157,6160,19,6179
8/7/2022,Wadena,Minnesota,27159,4594,58,4652
8/7/2022,Waseca,Minnesota,27161,5928,39,5967
8/7/2022,Washington,Minnesota,27163,74996,504,75500
8/7/2022,Watonwan,Minnesota,27165,3131,24,3155
8/7/2022,Hanover,Virginia,51085,25146,308,25454
8/7/2022,Hampton city,Virginia,51650,32959,339,33298
8/7/2022,Halifax,Virginia,51083,8293,168,8461
8/7/2022,Greensville,Virginia,51081,3599,41,3640
8/7/2022,Greene,Virginia,51079,4505,63,4568
8/7/2022,Grayson,Virginia,51077,4490,83,4573
8/7/2022,Goochland,Virginia,51075,4718,57,4775
8/7/2022,Gloucester,Virginia,51073,8205,107,8312
8/7/2022,Giles,Virginia,51071,4483,50,4533
8/7/2022,Galax city,Virginia,51640,2927,79,3006
8/7/2022,Wilkin,Minnesota,27167,1766,23,1789
8/7/2022,Winona,Minnesota,27169,14306,77,14383
8/7/2022,Wright,Minnesota,27171,39269,311,39580
8/7/2022,Yellow Medicine,Minnesota,27173,2761,31,2792
8/7/2022,Adams,Mississippi,28001,7977,146,8123
8/7/2022,Alcorn,Mississippi,28003,11153,161,11314
8/7/2022,Amite,Mississippi,28005,3515,70,3585
8/7/2022,Attala,Mississippi,28007,5919,116,6035
8/7/2022,Benton,Mississippi,28009,2438,49,2487
8/7/2022,Bolivar,Mississippi,28011,10180,184,10364
8/7/2022,Calhoun,Mississippi,28013,4904,72,4976
8/7/2022,Carroll,Mississippi,28015,2790,56,2846
8/7/2022,Chickasaw,Mississippi,28017,6121,97,6218
8/7/2022,Fredericksburg city,Virginia,51630,6182,41,6223
8/7/2022,Frederick,Virginia,51069,23134,257,23391
8/7/2022,Franklin city,Virginia,51620,2467,53,2520
8/7/2022,Franklin,Virginia,51067,12231,203,12434
8/7/2022,Fluvanna,Virginia,51065,5989,47,6036
8/7/2022,Floyd,Virginia,51063,2856,50,2906
8/7/2022,Fauquier,Virginia,51061,14596,152,14748
8/7/2022,Falls Church city,Virginia,51610,2926,17,2943
8/7/2022,Fairfax city,Virginia,51600,2302,45,2347
8/7/2022,Choctaw,Mississippi,28019,2541,33,2574
8/7/2022,Claiborne,Mississippi,28021,2367,46,2413
8/7/2022,Clarke,Mississippi,28023,4475,108,4583
8/7/2022,Clay,Mississippi,28025,5440,98,5538
8/7/2022,Coahoma,Mississippi,28027,7098,127,7225
8/7/2022,Copiah,Mississippi,28029,8165,121,8286
8/7/2022,Covington,Mississippi,28031,7726,115,7841
8/7/2022,DeSoto,Mississippi,28033,54867,558,55425
8/7/2022,Forrest,Mississippi,28035,24482,317,24799
8/7/2022,Fairfax,Virginia,51059,224265,1514,225779
8/7/2022,Essex,Virginia,51057,2465,35,2500
8/7/2022,Emporia city,Virginia,51595,1299,55,1354
8/7/2022,Dinwiddie,Virginia,51053,6186,96,6282
8/7/2022,Dickenson,Virginia,51051,3762,52,3814
8/7/2022,Danville city,Virginia,51590,12559,285,12844
8/7/2022,Cumberland,Virginia,51049,1550,27,1577
8/7/2022,Franklin,Mississippi,28037,2098,38,2136
8/7/2022,George,Mississippi,28039,7841,89,7930
8/7/2022,Greene,Mississippi,28041,3508,59,3567
8/7/2022,Grenada,Mississippi,28043,5872,133,6005
8/7/2022,Hancock,Mississippi,28045,13571,156,13727
8/7/2022,Harrison,Mississippi,28047,59503,677,60180
8/7/2022,Hinds,Mississippi,28049,59877,807,60684
8/7/2022,Culpeper,Virginia,51047,12636,157,12793
8/7/2022,Craig,Virginia,51045,1195,22,1217
8/7/2022,Covington city,Virginia,51580,1580,28,1608
8/7/2022,Colonial Heights city,Virginia,51570,5641,102,5743
8/7/2022,Clarke,Virginia,51043,3034,51,3085
8/7/2022,Chesterfield,Virginia,51041,86669,791,87460
8/7/2022,Chesapeake city,Virginia,51550,56906,524,57430
8/7/2022,Charlottesville city,Virginia,51540,11120,80,11200
8/7/2022,Holmes,Mississippi,28051,4761,104,4865
8/7/2022,Humphreys,Mississippi,28053,2151,47,2198
8/7/2022,Issaquena,Mississippi,28055,284,9,293
8/7/2022,Itawamba,Mississippi,28057,8005,145,8150
8/7/2022,Jackson,Mississippi,28059,41080,477,41557
8/7/2022,Jasper,Mississippi,28061,5489,75,5564
8/7/2022,Jefferson,Mississippi,28063,1656,37,1693
8/7/2022,Jefferson Davis,Mississippi,28065,3131,56,3187
8/7/2022,Jones,Mississippi,28067,23292,301,23593
8/7/2022,Kemper,Mississippi,28069,2337,50,2387
8/7/2022,Lafayette,Mississippi,28071,16821,179,17000
8/7/2022,Charlotte,Virginia,51037,2820,45,2865
8/7/2022,Charles City,Virginia,51036,1317,29,1346
8/7/2022,Carroll,Virginia,51035,7617,152,7769
8/7/2022,Caroline,Virginia,51033,7873,89,7962
8/7/2022,Washington,Ohio,39167,13538,211,13749
8/7/2022,Lamar,Mississippi,28073,19402,162,19564
8/7/2022,Lauderdale,Mississippi,28075,20040,373,20413
8/7/2022,Lawrence,Mississippi,28077,3951,57,4008
8/7/2022,Campbell,Virginia,51031,14972,224,15196
8/7/2022,Buena Vista city,Virginia,51530,2162,46,2208
8/7/2022,Leake,Mississippi,28079,6929,122,7051
8/7/2022,Lee,Mississippi,28081,29474,309,29783
8/7/2022,Leflore,Mississippi,28083,7970,171,8141
8/7/2022,Lincoln,Mississippi,28085,9232,159,9391
8/7/2022,Lowndes,Mississippi,28087,19022,242,19264
8/7/2022,Madison,Mississippi,28089,27598,336,27934
8/7/2022,Marion,Mississippi,28091,7679,136,7815
8/7/2022,Marshall,Mississippi,28093,10685,178,10863
8/7/2022,Monroe,Mississippi,28095,11870,223,12093
8/7/2022,Montgomery,Mississippi,28097,3232,79,3311
8/7/2022,Neshoba,Mississippi,28099,11413,243,11656
8/7/2022,Buckingham,Virginia,51029,4457,59,4516
8/7/2022,Buchanan,Virginia,51027,5209,128,5337
8/7/2022,Wayne,Ohio,39169,25154,446,25600
8/7/2022,Brunswick,Virginia,51025,3582,48,3630
8/7/2022,Bristol city,Virginia,51520,4975,83,5058
8/7/2022,Botetourt,Virginia,51023,8405,105,8510
8/7/2022,Bland,Virginia,51021,2013,24,2037
8/7/2022,Bedford,Virginia,51019,19062,249,19311
8/7/2022,Bath,Virginia,51017,1016,20,1036
8/7/2022,Augusta,Virginia,51015,21101,218,21319
8/7/2022,Newton,Mississippi,28101,6452,99,6551
8/7/2022,Noxubee,Mississippi,28103,3004,48,3052
8/7/2022,Oktibbeha,Mississippi,28105,12097,166,12263
8/7/2022,Panola,Mississippi,28107,11267,171,11438
8/7/2022,Pearl River,Mississippi,28109,16362,279,16641
8/7/2022,Perry,Mississippi,28111,3347,64,3411
8/7/2022,Pike,Mississippi,28113,10984,189,11173
8/7/2022,Arlington,Virginia,51013,57666,328,57994
8/7/2022,Appomattox,Virginia,51011,4308,55,4363
8/7/2022,Amherst,Virginia,51009,8207,96,8303
8/7/2022,Amelia,Virginia,51007,3002,59,3061
8/7/2022,Alleghany,Virginia,51005,3764,101,3865
8/7/2022,Alexandria city,Virginia,51510,39581,196,39777
8/7/2022,Albemarle,Virginia,51003,21674,176,21850
8/7/2022,Accomack,Virginia,51001,7838,111,7949
8/7/2022,Windsor,Vermont,50027,10603,60,10663
8/7/2022,Pontotoc,Mississippi,28115,11211,152,11363
8/7/2022,Prentiss,Mississippi,28117,8894,105,8999
8/7/2022,Quitman,Mississippi,28119,1694,32,1726
8/7/2022,Rankin,Mississippi,28121,41253,498,41751
8/7/2022,Scott,Mississippi,28123,7090,121,7211
8/7/2022,Sharkey,Mississippi,28125,1064,27,1091
8/7/2022,Simpson,Mississippi,28127,7784,152,7936
8/7/2022,Smith,Mississippi,28129,4485,69,4554
8/7/2022,Windham,Vermont,50025,7762,40,7802
8/7/2022,Washington,Vermont,50023,13225,56,13281
8/7/2022,Unknown,Vermont,,2199,4,2203
8/7/2022,Rutland,Vermont,50021,14852,79,14931
8/7/2022,Orleans,Vermont,50019,6921,38,6959
8/7/2022,Orange,Vermont,50017,4704,14,4718
8/7/2022,Lamoille,Vermont,50015,4121,17,4138
8/7/2022,Grand Isle,Vermont,50013,1193,6,1199
8/7/2022,Franklin,Vermont,50011,10720,68,10788
8/7/2022,Essex,Vermont,50009,1364,3,1367
8/7/2022,Stone,Mississippi,28131,5954,72,6026
8/7/2022,Sunflower,Mississippi,28133,6093,126,6219
8/7/2022,Tallahatchie,Mississippi,28135,3442,61,3503
8/7/2022,Tate,Mississippi,28137,8019,147,8166
8/7/2022,Tippah,Mississippi,28139,7954,109,8063
8/7/2022,Cimarron,Oklahoma,40025,614,7,621
8/7/2022,Tishomingo,Mississippi,28141,6687,122,6809
8/7/2022,Tunica,Mississippi,28143,2769,48,2817
8/7/2022,Union,Mississippi,28145,10290,125,10415
8/7/2022,Chittenden,Vermont,50007,36871,182,37053
8/7/2022,Caledonia,Vermont,50005,6213,31,6244
8/7/2022,Bennington,Vermont,50003,11024,73,11097
8/7/2022,Addison,Vermont,50001,6373,22,6395
8/7/2022,Weber,Utah,49057,78476,456,78932
8/7/2022,Wayne,Utah,49055,485,0,485
8/7/2022,Washington,Utah,49053,48036,475,48511
8/7/2022,Wasatch,Utah,49051,11514,36,11550
8/7/2022,Utah,Utah,49049,215269,827,216096
8/7/2022,Unknown,Utah,,4448,98,4546
8/7/2022,Uintah,Utah,49047,8837,75,8912
8/7/2022,Tooele,Utah,49045,23336,108,23444
8/7/2022,Unknown,Mississippi,,5681,31,5712
8/7/2022,Walthall,Mississippi,28147,4029,80,4109
8/7/2022,Warren,Mississippi,28149,11447,207,11654
8/7/2022,Washington,Mississippi,28151,11299,204,11503
8/7/2022,Wayne,Mississippi,28153,6389,87,6476
8/7/2022,Webster,Mississippi,28155,3615,72,3687
8/7/2022,Wilkinson,Mississippi,28157,1887,46,1933
8/7/2022,Winston,Mississippi,28159,5794,104,5898
8/7/2022,Summit,Utah,49043,15013,27,15040
8/7/2022,Sevier,Utah,49041,5670,30,5700
8/7/2022,Sanpete,Utah,49039,8645,56,8701
8/7/2022,San Juan,Utah,49037,4428,50,4478
8/7/2022,Yalobusha,Mississippi,28161,4447,58,4505
8/7/2022,Choctaw,Oklahoma,40023,4373,64,4437
8/7/2022,Salt Lake,Utah,49035,380746,1698,382444
8/7/2022,Rich,Utah,49033,361,0,361
8/7/2022,Piute,Utah,49031,322,7,329
8/7/2022,Morgan,Utah,49029,3071,15,3086
8/7/2022,Yazoo,Mississippi,28163,8749,110,8859
8/7/2022,Cherokee,Oklahoma,40021,15620,155,15775
8/7/2022,Adair,Missouri,29001,6010,68,6078
8/7/2022,Andrew,Missouri,29003,5138,59,5197
8/7/2022,Atchison,Missouri,29005,1514,23,1537
8/7/2022,Audrain,Missouri,29007,6096,114,6210
8/7/2022,Millard,Utah,49027,3467,36,3503
8/7/2022,Kane,Utah,49025,1479,15,1494
8/7/2022,Juab,Utah,49023,3050,26,3076
8/7/2022,Iron,Utah,49021,15628,95,15723
8/7/2022,Grand,Utah,49019,2603,6,2609
8/7/2022,Garfield,Utah,49017,997,16,1013
8/7/2022,Emery,Utah,49015,2678,28,2706
8/7/2022,Duchesne,Utah,49013,4728,27,4755
8/7/2022,Davis,Utah,49011,110536,418,110954
8/7/2022,Barry,Missouri,29009,7190,145,7335
8/7/2022,Barton,Missouri,29011,3059,52,3111
8/7/2022,Bates,Missouri,29013,3954,98,4052
8/7/2022,Benton,Missouri,29015,4795,109,4904
8/7/2022,Daggett,Utah,49009,162,0,162
8/7/2022,Bollinger,Missouri,29017,2831,44,2875
8/7/2022,Boone,Missouri,29019,49529,266,49795
8/7/2022,Buchanan,Missouri,29021,26667,323,26990
8/7/2022,Butler,Missouri,29023,10961,178,11139
8/7/2022,Carbon,Utah,49007,5652,49,5701
8/7/2022,Cache,Utah,49005,39346,112,39458
8/7/2022,Box Elder,Utah,49003,15032,126,15158
8/7/2022,Beaver,Utah,49001,1692,16,1708
8/7/2022,Zavala,Texas,48507,4282,69,4351
8/7/2022,Zapata,Texas,48505,4001,55,4056
8/7/2022,Young,Texas,48503,4266,95,4361
8/7/2022,Yoakum,Texas,48501,1405,42,1447
8/7/2022,Wood,Texas,48499,8632,289,8921
8/7/2022,Wise,Texas,48497,17935,274,18209
8/7/2022,Winkler,Texas,48495,1955,34,1989
8/7/2022,Wilson,Texas,48493,11810,160,11970
8/7/2022,Williamson,Texas,48491,153334,942,154276
8/7/2022,Caldwell,Missouri,29025,1842,39,1881
8/7/2022,Callaway,Missouri,29027,12941,133,13074
8/7/2022,Camden,Missouri,29029,10000,185,10185
8/7/2022,Cape Girardeau,Missouri,29031,20768,250,21018
8/7/2022,Carroll,Missouri,29033,2353,45,2398
8/7/2022,Carter,Missouri,29035,1583,24,1607
8/7/2022,Cass,Missouri,29037,27385,323,27708
8/7/2022,Willacy,Texas,48489,7952,134,8086
8/7/2022,Wilbarger,Texas,48487,3753,89,3842
8/7/2022,Wichita,Texas,48485,36137,687,36824
8/7/2022,Wheeler,Texas,48483,1249,23,1272
8/7/2022,Wharton,Texas,48481,10309,220,10529
8/7/2022,Carter,Oklahoma,40019,15793,242,16035
8/7/2022,Webb,Texas,48479,102950,1045,103995
8/7/2022,Washington,Texas,48477,10000,151,10151
8/7/2022,Ward,Texas,48475,2985,46,3031
8/7/2022,Waller,Texas,48473,10656,108,10764
8/7/2022,Cedar,Missouri,29039,3277,59,3336
8/7/2022,Chariton,Missouri,29041,1827,38,1865
8/7/2022,Christian,Missouri,29043,22667,268,22935
8/7/2022,Clark,Missouri,29045,1737,40,1777
8/7/2022,Clay,Missouri,29047,29864,375,30239
8/7/2022,Clinton,Missouri,29049,5162,123,5285
8/7/2022,Cole,Missouri,29051,21455,291,21746
8/7/2022,Cooper,Missouri,29053,4357,79,4436
8/7/2022,Crawford,Missouri,29055,5832,108,5940
8/7/2022,Dade,Missouri,29057,1597,43,1640
8/7/2022,Dallas,Missouri,29059,4180,75,4255
8/7/2022,Daviess,Missouri,29061,1843,30,1873
8/7/2022,Walker,Texas,48471,20583,214,20797
8/7/2022,Victoria,Texas,48469,20825,413,21238
8/7/2022,Van Zandt,Texas,48467,11224,285,11509
8/7/2022,Val Verde,Texas,48465,15293,305,15598
8/7/2022,Uvalde,Texas,48463,11085,146,11231
8/7/2022,Upton,Texas,48461,875,18,893
8/7/2022,Upshur,Texas,48459,8322,187,8509
8/7/2022,Tyler,Texas,48457,4201,88,4289
8/7/2022,Trinity,Texas,48455,2931,73,3004
8/7/2022,Travis,Texas,48453,262353,1762,264115
8/7/2022,Tom Green,Texas,48451,45567,556,46123
8/7/2022,DeKalb,Missouri,29063,2340,47,2387
8/7/2022,Dent,Missouri,29065,3526,87,3613
8/7/2022,Douglas,Missouri,29067,2752,83,2835
8/7/2022,Dunklin,Missouri,29069,8609,129,8738
8/7/2022,Franklin,Missouri,29071,28057,382,28439
8/7/2022,Gasconade,Missouri,29073,3636,104,3740
8/7/2022,Gentry,Missouri,29075,2335,32,2367
8/7/2022,Greene,Missouri,29077,77249,1070,78319
8/7/2022,Grundy,Missouri,29079,2767,69,2836
8/7/2022,Titus,Texas,48449,9215,129,9344
8/7/2022,Throckmorton,Texas,48447,279,9,288
8/7/2022,Terry,Texas,48445,2845,85,2930
8/7/2022,Terrell,Texas,48443,131,3,134
8/7/2022,Taylor,Texas,48441,38292,731,39023
8/7/2022,Tarrant,Texas,48439,617163,6003,623166
8/7/2022,Swisher,Texas,48437,2420,34,2454
8/7/2022,Sutton,Texas,48435,868,13,881
8/7/2022,Harrison,Missouri,29081,2082,35,2117
8/7/2022,Henry,Missouri,29083,6336,89,6425
8/7/2022,Hickory,Missouri,29085,2056,56,2112
8/7/2022,Holt,Missouri,29087,1158,30,1188
8/7/2022,Howard,Missouri,29089,2642,30,2672
8/7/2022,Howell,Missouri,29091,9903,223,10126
8/7/2022,Iron,Missouri,29093,2357,46,2403
8/7/2022,Jackson,Missouri,29095,105805,1238,107043
8/7/2022,Jasper,Missouri,29097,22249,326,22575
8/7/2022,Stonewall,Texas,48433,379,7,386
8/7/2022,Sterling,Texas,48431,289,7,296
8/7/2022,Stephens,Texas,48429,1959,47,2006
8/7/2022,Starr,Texas,48427,21863,367,22230
8/7/2022,Somervell,Texas,48425,2150,36,2186
8/7/2022,Smith,Texas,48423,50423,977,51400
8/7/2022,Jefferson,Missouri,29099,60147,667,60814
8/7/2022,Johnson,Missouri,29101,13070,145,13215
8/7/2022,Joplin,Missouri,,14842,222,15064
8/7/2022,Kansas City,Missouri,,126193,1344,127537
8/7/2022,Knox,Missouri,29103,1094,14,1108
8/7/2022,Sherman,Texas,48421,508,16,524
8/7/2022,Shelby,Texas,48419,4739,134,4873
8/7/2022,Shackelford,Texas,48417,727,12,739
8/7/2022,Scurry,Texas,48415,5299,105,5404
8/7/2022,Schleicher,Texas,48413,554,9,563
8/7/2022,San Saba,Texas,48411,1325,35,1360
8/7/2022,San Patricio,Texas,48409,12676,341,13017
8/7/2022,Laclede,Missouri,29105,8721,182,8903
8/7/2022,Lafayette,Missouri,29107,8407,137,8544
8/7/2022,San Jacinto,Texas,48407,6128,104,6232
8/7/2022,San Augustine,Texas,48405,1134,45,1179
8/7/2022,Sabine,Texas,48403,1389,88,1477
8/7/2022,Rusk,Texas,48401,11511,234,11745
8/7/2022,Lawrence,Missouri,29109,8350,171,8521
8/7/2022,Lewis,Missouri,29111,2999,43,3042
8/7/2022,Lincoln,Missouri,29113,16478,144,16622
8/7/2022,Linn,Missouri,29115,2775,66,2841
8/7/2022,Livingston,Missouri,29117,3991,100,4091
8/7/2022,Macon,Missouri,29121,3907,61,3968
8/7/2022,Madison,Missouri,29123,3851,58,3909
8/7/2022,Maries,Missouri,29125,1730,39,1769
8/7/2022,Runnels,Texas,48399,2539,68,2607
8/7/2022,Rockwall,Texas,48397,28882,268,29150
8/7/2022,Robertson,Texas,48395,4868,77,4945
8/7/2022,Roberts,Texas,48393,183,2,185
8/7/2022,Refugio,Texas,48391,1989,38,2027
8/7/2022,Reeves,Texas,48389,4992,74,5066
8/7/2022,Red River,Texas,48387,2473,68,2541
8/7/2022,Real,Texas,48385,904,25,929
8/7/2022,Marion,Missouri,29127,8765,126,8891
8/7/2022,McDonald,Missouri,29119,6170,81,6251
8/7/2022,Mercer,Missouri,29129,788,14,802
8/7/2022,Miller,Missouri,29131,6437,125,6562
8/7/2022,Reagan,Texas,48383,921,14,935
8/7/2022,Randall,Texas,48381,40761,525,41286
8/7/2022,Rains,Texas,48379,1987,59,2046
8/7/2022,Presidio,Texas,48377,1066,39,1105
8/7/2022,Potter,Texas,48375,38370,752,39122
8/7/2022,Polk,Texas,48373,8532,251,8783
8/7/2022,Pending County Assignment,Texas,,65,0,65
8/7/2022,Mississippi,Missouri,29133,3877,59,3936
8/7/2022,Moniteau,Missouri,29135,3989,57,4046
8/7/2022,Monroe,Missouri,29137,2306,46,2352
8/7/2022,Montgomery,Missouri,29139,2739,58,2797
8/7/2022,Morgan,Missouri,29141,4344,116,4460
8/7/2022,New Madrid,Missouri,29143,5436,86,5522
8/7/2022,Newton,Missouri,29145,12642,211,12853
8/7/2022,Nodaway,Missouri,29147,6563,46,6609
8/7/2022,Oregon,Missouri,29149,2155,37,2192
8/7/2022,Osage,Missouri,29151,3390,46,3436
8/7/2022,Ozark,Missouri,29153,1860,63,1923
8/7/2022,Pemiscot,Missouri,29155,3279,81,3360
8/7/2022,Pecos,Texas,48371,3101,71,3172
8/7/2022,Parmer,Texas,48369,2489,53,2542
8/7/2022,Parker,Texas,48367,37178,461,37639
8/7/2022,Panola,Texas,48365,5020,132,5152
8/7/2022,Perry,Missouri,29157,5556,46,5602
8/7/2022,Pettis,Missouri,29159,13325,174,13499
8/7/2022,Palo Pinto,Texas,48363,7440,155,7595
8/7/2022,Orange,Texas,48361,16264,363,16627
8/7/2022,Oldham,Texas,48359,591,6,597
8/7/2022,Phelps,Missouri,29161,11300,251,11551
8/7/2022,Pike,Missouri,29163,4579,64,4643
8/7/2022,Platte,Missouri,29165,11561,102,11663
8/7/2022,Polk,Missouri,29167,8864,109,8973
8/7/2022,Pulaski,Missouri,29169,9899,118,10017
8/7/2022,Putnam,Missouri,29171,1095,25,1120
8/7/2022,Ralls,Missouri,29173,2653,30,2683
8/7/2022,Ochiltree,Texas,48357,2541,48,2589
8/7/2022,Nueces,Texas,48355,104103,1528,105631
8/7/2022,Nolan,Texas,48353,3324,100,3424
8/7/2022,Newton,Texas,48351,1572,62,1634
8/7/2022,Navarro,Texas,48349,13194,223,13417
8/7/2022,Nacogdoches,Texas,48347,13368,263,13631
8/7/2022,Motley,Texas,48345,300,13,313
8/7/2022,Morris,Texas,48343,2703,74,2777
8/7/2022,Moore,Texas,48341,5960,113,6073
8/7/2022,Montgomery,Texas,48339,157833,1314,159147
8/7/2022,Montague,Texas,48337,4924,130,5054
8/7/2022,Randolph,Missouri,29175,6411,107,6518
8/7/2022,Ray,Missouri,29177,5588,96,5684
8/7/2022,Reynolds,Missouri,29179,1248,27,1275
8/7/2022,Ripley,Missouri,29181,2882,62,2944
8/7/2022,Saline,Missouri,29195,6682,109,6791
8/7/2022,Schuyler,Missouri,29197,800,27,827
8/7/2022,Scotland,Missouri,29199,719,18,737
8/7/2022,Scott,Missouri,29201,12175,164,12339
8/7/2022,Shannon,Missouri,29203,1716,40,1756
8/7/2022,Shelby,Missouri,29205,1805,15,1820
8/7/2022,Mitchell,Texas,48335,1988,49,2037
8/7/2022,Mills,Texas,48333,1495,37,1532
8/7/2022,Milam,Texas,48331,5393,105,5498
8/7/2022,Midland,Texas,48329,43522,502,44024
8/7/2022,Menard,Texas,48327,577,12,589
8/7/2022,Medina,Texas,48325,11000,202,11202
8/7/2022,McMullen,Texas,48311,175,9,184
8/7/2022,McLennan,Texas,48309,66504,916,67420
8/7/2022,McCulloch,Texas,48307,1427,47,1474
8/7/2022,Maverick,Texas,48323,22677,471,23148
8/7/2022,Matagorda,Texas,48321,9261,177,9438
8/7/2022,Mason,Texas,48319,869,13,882
8/7/2022,Martin,Texas,48317,1305,26,1331
8/7/2022,St. Charles,Missouri,29183,115784,969,116753
8/7/2022,St. Clair,Missouri,29185,2293,38,2331
8/7/2022,Ste. Genevieve,Missouri,29186,4093,39,4132
8/7/2022,St. Francois,Missouri,29187,20619,304,20923
8/7/2022,St. Louis,Missouri,29189,258895,3434,262329
8/7/2022,St. Louis city,Missouri,29510,66992,803,67795
8/7/2022,Stoddard,Missouri,29207,6546,139,6685
8/7/2022,Marion,Texas,48315,1803,60,1863
8/7/2022,Madison,Texas,48313,3976,57,4033
8/7/2022,Lynn,Texas,48305,1594,38,1632
8/7/2022,Lubbock,Texas,48303,100902,1346,102248
8/7/2022,Loving,Texas,48301,301,1,302
8/7/2022,Llano,Texas,48299,4453,97,4550
8/7/2022,Live Oak,Texas,48297,2270,42,2312
8/7/2022,Lipscomb,Texas,48295,752,17,769
8/7/2022,Limestone,Texas,48293,5459,125,5584
8/7/2022,Liberty,Texas,48291,20141,407,20548
8/7/2022,Leon,Texas,48289,3932,94,4026
8/7/2022,Lee,Texas,48287,4680,62,4742
8/7/2022,Lavaca,Texas,48285,4512,122,4634
8/7/2022,Stone,Missouri,29209,6324,123,6447
8/7/2022,Sullivan,Missouri,29211,1823,24,1847
8/7/2022,Taney,Missouri,29213,14682,236,14918
8/7/2022,Texas,Missouri,29215,5032,107,5139
8/7/2022,Vernon,Missouri,29217,5538,111,5649
8/7/2022,Warren,Missouri,29219,8885,106,8991
8/7/2022,Washington,Missouri,29221,6448,145,6593
8/7/2022,Wayne,Missouri,29223,2581,54,2635
8/7/2022,Webster,Missouri,29225,9522,155,9677
8/7/2022,La Salle,Texas,48283,2484,49,2533
8/7/2022,Worth,Missouri,29227,434,3,437
8/7/2022,Wright,Missouri,29229,4152,90,4242
8/7/2022,Beaverhead,Montana,30001,2304,30,2334
8/7/2022,Big Horn,Montana,30003,5233,101,5334
8/7/2022,Blaine,Montana,30005,2273,33,2306
8/7/2022,Lampasas,Texas,48281,5910,93,6003
8/7/2022,Lamb,Texas,48279,4606,122,4728
8/7/2022,Lamar,Texas,48277,13431,260,13691
8/7/2022,Broadwater,Montana,30007,1383,21,1404
8/7/2022,Carbon,Montana,30009,2227,28,2255
8/7/2022,Knox,Texas,48275,544,25,569
8/7/2022,Carter,Montana,30011,267,5,272
8/7/2022,Kleberg,Texas,48273,8335,150,8485
8/7/2022,Kinney,Texas,48271,785,12,797
8/7/2022,King,Texas,48269,52,0,52
8/7/2022,Kimble,Texas,48267,798,15,813
8/7/2022,Kerr,Texas,48265,10283,186,10469
8/7/2022,Kent,Texas,48263,215,4,219
8/7/2022,Kenedy,Texas,48261,94,2,96
8/7/2022,Kendall,Texas,48259,9025,125,9150
8/7/2022,Kaufman,Texas,48257,38561,537,39098
8/7/2022,Karnes,Texas,48255,6178,71,6249
8/7/2022,Jones,Texas,48253,4873,93,4966
8/7/2022,Johnson,Texas,48251,47134,748,47882
8/7/2022,Jim Wells,Texas,48249,12733,215,12948
8/7/2022,Jim Hogg,Texas,48247,3195,22,3217
8/7/2022,Jefferson,Texas,48245,56985,859,57844
8/7/2022,Cascade,Montana,30013,27093,354,27447
8/7/2022,Chouteau,Montana,30015,1090,15,1105
8/7/2022,Custer,Montana,30017,3206,50,3256
8/7/2022,Daniels,Montana,30019,420,9,429
8/7/2022,Dawson,Montana,30021,2531,59,2590
8/7/2022,Deer Lodge,Montana,30023,2832,30,2862
8/7/2022,Fallon,Montana,30025,708,10,718
8/7/2022,Fergus,Montana,30027,2640,58,2698
8/7/2022,Flathead,Montana,30029,31454,290,31744
8/7/2022,Jeff Davis,Texas,48243,249,9,258
8/7/2022,Jasper,Texas,48241,7171,190,7361
8/7/2022,Jackson,Texas,48239,3515,59,3574
8/7/2022,Jack,Texas,48237,1592,29,1621
8/7/2022,Irion,Texas,48235,522,3,525
8/7/2022,Hutchinson,Texas,48233,7070,137,7207
8/7/2022,Hunt,Texas,48231,17259,365,17624
8/7/2022,Hudspeth,Texas,48229,1107,18,1125
8/7/2022,Howard,Texas,48227,7267,185,7452
8/7/2022,Gallatin,Montana,30031,38518,124,38642
8/7/2022,Garfield,Montana,30033,243,3,246
8/7/2022,Glacier,Montana,30035,4310,75,4385
8/7/2022,Golden Valley,Montana,30037,155,5,160
8/7/2022,Granite,Montana,30039,597,10,607
8/7/2022,Hill,Montana,30041,4914,73,4987
8/7/2022,Jefferson,Montana,30043,2866,25,2891
8/7/2022,Judith Basin,Montana,30045,248,1,249
8/7/2022,Lake,Montana,30047,7359,102,7461
8/7/2022,Lewis and Clark,Montana,30049,19865,192,20057
8/7/2022,Liberty,Montana,30051,445,4,449
8/7/2022,Houston,Texas,48225,4524,113,4637
8/7/2022,Hopkins,Texas,48223,7730,183,7913
8/7/2022,Hood,Texas,48221,14014,278,14292
8/7/2022,Hockley,Texas,48219,8298,164,8462
8/7/2022,Hill,Texas,48217,9409,195,9604
8/7/2022,Hidalgo,Texas,48215,234433,3945,238378
8/7/2022,Henderson,Texas,48213,16539,428,16967
8/7/2022,Hemphill,Texas,48211,1297,7,1304
8/7/2022,Lincoln,Montana,30053,5151,90,5241
8/7/2022,Madison,Montana,30057,2117,23,2140
8/7/2022,McCone,Montana,30055,406,9,415
8/7/2022,Meagher,Montana,30059,493,10,503
8/7/2022,Canadian,Oklahoma,40017,43019,394,43413
8/7/2022,Mineral,Montana,30061,1219,17,1236
8/7/2022,Missoula,Montana,30063,30666,214,30880
8/7/2022,Musselshell,Montana,30065,974,31,1005
8/7/2022,Park,Montana,30067,4779,36,4815
8/7/2022,Petroleum,Montana,30069,35,1,36
8/7/2022,Phillips,Montana,30071,1093,29,1122
8/7/2022,Pondera,Montana,30073,1306,9,1315
8/7/2022,Hays,Texas,48209,70396,529,70925
8/7/2022,Haskell,Texas,48207,961,39,1000
8/7/2022,Hartley,Texas,48205,1401,3,1404
8/7/2022,Harrison,Texas,48203,14331,227,14558
8/7/2022,Harris,Texas,48201,1164711,11137,1175848
8/7/2022,Hardin,Texas,48199,13514,252,13766
8/7/2022,Hardeman,Texas,48197,574,19,593
8/7/2022,Hansford,Texas,48195,2104,29,2133
8/7/2022,Hamilton,Texas,48193,2011,34,2045
8/7/2022,Hall,Texas,48191,1166,24,1190
8/7/2022,Hale,Texas,48189,7233,246,7479
8/7/2022,Powder River,Montana,30075,386,10,396
8/7/2022,Powell,Montana,30077,2044,31,2075
8/7/2022,Prairie,Montana,30079,275,3,278
8/7/2022,Ravalli,Montana,30081,7638,166,7804
8/7/2022,Richland,Montana,30083,2766,36,2802
8/7/2022,Guadalupe,Texas,48187,41811,406,42217
8/7/2022,Grimes,Texas,48185,9303,125,9428
8/7/2022,Gregg,Texas,48183,24811,696,25507
8/7/2022,Grayson,Texas,48181,29002,649,29651
8/7/2022,Gray,Texas,48179,6515,128,6643
8/7/2022,Gonzales,Texas,48177,5028,103,5131
8/7/2022,Goliad,Texas,48175,1357,32,1389
8/7/2022,Glasscock,Texas,48173,218,3,221
8/7/2022,Gillespie,Texas,48171,5800,109,5909
8/7/2022,Roosevelt,Montana,30085,3458,75,3533
8/7/2022,Rosebud,Montana,30087,2803,61,2864
8/7/2022,Sanders,Montana,30089,2274,52,2326
8/7/2022,Sheridan,Montana,30091,793,12,805
8/7/2022,Silver Bow,Montana,30093,9124,134,9258
8/7/2022,Caddo,Oklahoma,40015,8923,172,9095
8/7/2022,Stillwater,Montana,30095,1615,32,1647
8/7/2022,Sweet Grass,Montana,30097,839,13,852
8/7/2022,Garza,Texas,48169,1342,29,1371
8/7/2022,Galveston,Texas,48167,110052,867,110919
8/7/2022,Gaines,Texas,48165,2267,83,2350
8/7/2022,Frio,Texas,48163,6322,94,6416
8/7/2022,Freestone,Texas,48161,4036,83,4119
8/7/2022,Franklin,Texas,48159,2363,45,2408
8/7/2022,Fort Bend,Texas,48157,221718,1279,222997
8/7/2022,Foard,Texas,48155,227,11,238
8/7/2022,Floyd,Texas,48153,2104,48,2152
8/7/2022,Fisher,Texas,48151,650,26,676
8/7/2022,Teton,Montana,30099,1403,26,1429
8/7/2022,Toole,Montana,30101,1318,25,1343
8/7/2022,Treasure,Montana,30103,141,1,142
8/7/2022,Valley,Montana,30105,1902,38,1940
8/7/2022,Wheatland,Montana,30107,408,14,422
8/7/2022,Wibaux,Montana,30109,210,8,218
8/7/2022,Yellowstone,Montana,30111,46175,568,46743
8/7/2022,Fayette,Texas,48149,5122,113,5235
8/7/2022,Fannin,Texas,48147,7345,185,7530
8/7/2022,Falls,Texas,48145,4033,68,4101
8/7/2022,Erath,Texas,48143,9166,124,9290
8/7/2022,El Paso,Texas,48141,230438,3772,234210
8/7/2022,Ellis,Texas,48139,52852,590,53442
8/7/2022,Edwards,Texas,48137,514,11,525
8/7/2022,Ector,Texas,48135,39861,712,40573
8/7/2022,Eastland,Texas,48133,3010,114,3124
8/7/2022,Duval,Texas,48131,3847,70,3917
8/7/2022,Donley,Texas,48129,1204,26,1230
8/7/2022,Dimmit,Texas,48127,6012,51,6063
8/7/2022,Dickens,Texas,48125,479,16,495
8/7/2022,DeWitt,Texas,48123,6868,100,6968
8/7/2022,Adams,Nebraska,31001,7042,73,7115
8/7/2022,Antelope,Nebraska,31003,1163,14,1177
8/7/2022,Arthur,Nebraska,31005,33,1,34
8/7/2022,Banner,Nebraska,31007,92,2,94
8/7/2022,Blaine,Nebraska,31009,71,3,74
8/7/2022,Boone,Nebraska,31011,1125,5,1130
8/7/2022,Box Butte,Nebraska,31013,2336,17,2353
8/7/2022,Boyd,Nebraska,31015,425,7,432
8/7/2022,Denton,Texas,48121,200532,1379,201911
8/7/2022,Delta,Texas,48119,1913,27,1940
8/7/2022,Deaf Smith,Texas,48117,5203,115,5318
8/7/2022,Dawson,Texas,48115,3146,96,3242
8/7/2022,Dallas,Texas,48113,627844,6832,634676
8/7/2022,Dallam,Texas,48111,2251,43,2294
8/7/2022,Culberson,Texas,48109,523,14,537
8/7/2022,Crosby,Texas,48107,2000,45,2045
8/7/2022,Brown,Nebraska,31017,582,4,586
8/7/2022,Crockett,Texas,48105,1207,20,1227
8/7/2022,Buffalo,Nebraska,31019,12932,104,13036
8/7/2022,Crane,Texas,48103,1382,24,1406
8/7/2022,Burt,Nebraska,31021,1390,17,1407
8/7/2022,Butler,Nebraska,31023,2060,18,2078
8/7/2022,Cass,Nebraska,31025,6569,46,6615
8/7/2022,Cedar,Nebraska,31027,1555,14,1569
8/7/2022,Chase,Nebraska,31029,842,7,849
8/7/2022,Cherry,Nebraska,31031,583,12,595
8/7/2022,Cheyenne,Nebraska,31033,2161,24,2185
8/7/2022,Clay,Nebraska,31035,1596,25,1621
8/7/2022,Bryan,Oklahoma,40013,14824,138,14962
8/7/2022,Cottle,Texas,48101,347,9,356
8/7/2022,Coryell,Texas,48099,19127,215,19342
8/7/2022,Cooke,Texas,48097,7893,134,8027
8/7/2022,Concho,Texas,48095,1193,11,1204
8/7/2022,Comanche,Texas,48093,3834,78,3912
8/7/2022,Comal,Texas,48091,38737,564,39301
8/7/2022,Colorado,Texas,48089,4091,66,4157
8/7/2022,Colfax,Nebraska,31037,2775,28,2803
8/7/2022,Cuming,Nebraska,31039,1889,15,1904
8/7/2022,Custer,Nebraska,31041,2138,31,2169
8/7/2022,Dakota,Nebraska,31043,7243,82,7325
8/7/2022,Dawes,Nebraska,31045,1440,21,1461
8/7/2022,Dawson,Nebraska,31047,5525,44,5569
8/7/2022,Deuel,Nebraska,31049,332,3,335
8/7/2022,Dixon,Nebraska,31051,1264,11,1275
8/7/2022,Dodge,Nebraska,31053,10723,111,10834
8/7/2022,Douglas,Nebraska,31055,164315,1145,165460
8/7/2022,Dundy,Nebraska,31057,347,6,353
8/7/2022,Fillmore,Nebraska,31059,1205,13,1218
8/7/2022,Franklin,Nebraska,31061,437,13,450
8/7/2022,Frontier,Nebraska,31063,568,3,571
8/7/2022,Collingsworth,Texas,48087,775,16,791
8/7/2022,Collin,Texas,48085,242141,1527,243668
8/7/2022,Coleman,Texas,48083,1756,72,1828
8/7/2022,Coke,Texas,48081,954,20,974
8/7/2022,Cochran,Texas,48079,930,23,953
8/7/2022,Clay,Texas,48077,2291,39,2330
8/7/2022,Childress,Texas,48075,2777,34,2811
8/7/2022,Furnas,Nebraska,31065,1191,8,1199
8/7/2022,Gage,Nebraska,31067,3735,45,3780
8/7/2022,Garden,Nebraska,31069,401,1,402
8/7/2022,Cherokee,Texas,48073,8631,254,8885
8/7/2022,Chambers,Texas,48071,13206,113,13319
8/7/2022,Castro,Texas,48069,2471,47,2518
8/7/2022,Cass,Texas,48067,7845,197,8042
8/7/2022,Carson,Texas,48065,1613,37,1650
8/7/2022,Camp,Texas,48063,3116,76,3192
8/7/2022,Cameron,Texas,48061,119496,2057,121553
8/7/2022,Callahan,Texas,48059,3173,73,3246
8/7/2022,Calhoun,Texas,48057,6332,52,6384
8/7/2022,Garfield,Nebraska,31071,418,2,420
8/7/2022,Gosper,Nebraska,31073,407,7,414
8/7/2022,Grant,Nebraska,31075,101,6,107
8/7/2022,Greeley,Nebraska,31077,434,2,436
8/7/2022,Hall,Nebraska,31079,17488,147,17635
8/7/2022,Hamilton,Nebraska,31081,2491,26,2517
8/7/2022,Harlan,Nebraska,31083,369,3,372
8/7/2022,Hayes,Nebraska,31085,100,0,100
8/7/2022,Hitchcock,Nebraska,31087,576,8,584
8/7/2022,Holt,Nebraska,31089,2304,20,2324
8/7/2022,Hooker,Nebraska,31091,117,5,122
8/7/2022,Howard,Nebraska,31093,1244,16,1260
8/7/2022,Jefferson,Nebraska,31095,1269,7,1276
8/7/2022,Caldwell,Texas,48055,16122,181,16303
8/7/2022,Burnet,Texas,48053,12222,173,12395
8/7/2022,Burleson,Texas,48051,5436,67,5503
8/7/2022,Brown,Texas,48049,12953,229,13182
8/7/2022,Brooks,Texas,48047,1830,52,1882
8/7/2022,Briscoe,Texas,48045,489,8,497
8/7/2022,Brewster,Texas,48043,1175,31,1206
8/7/2022,Brazos,Texas,48041,67370,422,67792
8/7/2022,Brazoria,Texas,48039,106902,997,107899
8/7/2022,Bowie,Texas,48037,21887,439,22326
8/7/2022,Bosque,Texas,48035,4395,70,4465
8/7/2022,Borden,Texas,48033,111,2,113
8/7/2022,Blanco,Texas,48031,2867,35,2902
8/7/2022,Bexar,Texas,48029,627494,6237,633731
8/7/2022,Johnson,Nebraska,31097,890,10,900
8/7/2022,Kearney,Nebraska,31099,1294,9,1303
8/7/2022,Keith,Nebraska,31101,1638,20,1658
8/7/2022,Keya Paha,Nebraska,31103,123,0,123
8/7/2022,Kimball,Nebraska,31105,781,9,790
8/7/2022,Bell,Texas,48027,75372,918,76290
8/7/2022,Bee,Texas,48025,9194,154,9348
8/7/2022,Baylor,Texas,48023,863,33,896
8/7/2022,Bastrop,Texas,48021,24483,241,24724
8/7/2022,Bandera,Texas,48019,3959,78,4037
8/7/2022,Bailey,Texas,48017,1667,39,1706
8/7/2022,Austin,Texas,48015,6400,78,6478
8/7/2022,Atascosa,Texas,48013,14641,233,14874
8/7/2022,Armstrong,Texas,48011,615,10,625
8/7/2022,Archer,Texas,48009,2407,28,2435
8/7/2022,Aransas,Texas,48007,4871,89,4960
8/7/2022,Angelina,Texas,48005,16157,489,16646
8/7/2022,Andrews,Texas,48003,4328,72,4400
8/7/2022,Anderson,Texas,48001,10196,242,10438
8/7/2022,Knox,Nebraska,31107,1738,13,1751
8/7/2022,Lancaster,Nebraska,31109,85620,446,86066
8/7/2022,Lincoln,Nebraska,31111,9489,120,9609
8/7/2022,Logan,Nebraska,31113,152,0,152
8/7/2022,Loup,Nebraska,31115,84,0,84
8/7/2022,Madison,Nebraska,31119,10271,70,10341
8/7/2022,Wilson,Tennessee,47189,45517,503,46020
8/7/2022,Williamson,Tennessee,47187,68477,415,68892
8/7/2022,White,Tennessee,47185,8714,130,8844
8/7/2022,Weakley,Tennessee,47183,10222,164,10386
8/7/2022,Wayne,Tennessee,47181,6021,73,6094
8/7/2022,Washington,Tennessee,47179,41848,507,42355
8/7/2022,Warren,Tennessee,47177,13905,181,14086
8/7/2022,Van Buren,Tennessee,47175,1950,48,1998
8/7/2022,Unknown,Tennessee,,26867,308,27175
8/7/2022,McPherson,Nebraska,31117,71,1,72
8/7/2022,Merrick,Nebraska,31121,1837,17,1854
8/7/2022,Morrill,Nebraska,31123,1198,21,1219
8/7/2022,Nance,Nebraska,31125,809,13,822
8/7/2022,Nemaha,Nebraska,31127,1437,20,1457
8/7/2022,Nuckolls,Nebraska,31129,1017,13,1030
8/7/2022,Union,Tennessee,47173,5942,78,6020
8/7/2022,Unicoi,Tennessee,47171,5576,97,5673
8/7/2022,Trousdale,Tennessee,47169,4379,47,4426
8/7/2022,Tipton,Tennessee,47167,19334,241,19575
8/7/2022,Sumner,Tennessee,47165,57892,754,58646
8/7/2022,Sullivan,Tennessee,47163,49969,743,50712
8/7/2022,Otoe,Nebraska,31131,3599,21,3620
8/7/2022,Pawnee,Nebraska,31133,462,4,466
8/7/2022,Perkins,Nebraska,31135,549,12,561
8/7/2022,Phelps,Nebraska,31137,2496,14,2510
8/7/2022,Pierce,Nebraska,31139,1330,21,1351
8/7/2022,Platte,Nebraska,31141,9160,75,9235
8/7/2022,Stewart,Tennessee,47161,3441,63,3504
8/7/2022,Smith,Tennessee,47159,6529,87,6616
8/7/2022,Shelby,Tennessee,47157,266953,3427,270380
8/7/2022,Sevier,Tennessee,47155,32599,426,33025
8/7/2022,Sequatchie,Tennessee,47153,4553,70,4623
8/7/2022,Scott,Tennessee,47151,10010,122,10132
8/7/2022,Rutherford,Tennessee,47149,104366,920,105286
8/7/2022,Robertson,Tennessee,47147,22997,314,23311
8/7/2022,Polk,Nebraska,31143,1241,18,1259
8/7/2022,Red Willow,Nebraska,31145,2463,20,2483
8/7/2022,Richardson,Nebraska,31147,1969,24,1993
8/7/2022,Rock,Nebraska,31149,185,2,187
8/7/2022,Saline,Nebraska,31151,3965,12,3977
8/7/2022,Roane,Tennessee,47145,17034,237,17271
8/7/2022,Rhea,Tennessee,47143,10643,164,10807
8/7/2022,Putnam,Tennessee,47141,26659,308,26967
8/7/2022,Polk,Tennessee,47139,5052,83,5135
8/7/2022,Pickett,Tennessee,47137,1925,38,1963
8/7/2022,Perry,Tennessee,47135,2485,56,2541
8/7/2022,Sarpy,Nebraska,31153,53752,290,54042
8/7/2022,Overton,Tennessee,47133,7625,126,7751
8/7/2022,Obion,Tennessee,47131,11645,203,11848
8/7/2022,Morgan,Tennessee,47129,6587,88,6675
8/7/2022,Saunders,Nebraska,31155,5248,30,5278
8/7/2022,Scotts Bluff,Nebraska,31157,10079,102,10181
8/7/2022,Seward,Nebraska,31159,3517,43,3560
8/7/2022,Sheridan,Nebraska,31161,1034,23,1057
8/7/2022,Sherman,Nebraska,31163,625,4,629
8/7/2022,Sioux,Nebraska,31165,79,1,80
8/7/2022,Stanton,Nebraska,31167,685,11,696
8/7/2022,Thayer,Nebraska,31169,1174,8,1182
8/7/2022,Moore,Tennessee,47127,2377,40,2417
8/7/2022,Montgomery,Tennessee,47125,54706,596,55302
8/7/2022,Monroe,Tennessee,47123,15593,250,15843
8/7/2022,Meigs,Tennessee,47121,3643,59,3702
8/7/2022,McNairy,Tennessee,47109,8354,128,8482
8/7/2022,McMinn,Tennessee,47107,17754,269,18023
8/7/2022,Maury,Tennessee,47119,31327,356,31683
8/7/2022,Thomas,Nebraska,31171,104,1,105
8/7/2022,Thurston,Nebraska,31173,1837,23,1860
8/7/2022,Unknown,Nebraska,,7425,511,7936
8/7/2022,Valley,Nebraska,31175,781,6,787
8/7/2022,Marshall,Tennessee,47117,11045,125,11170
8/7/2022,Marion,Tennessee,47115,9613,133,9746
8/7/2022,Madison,Tennessee,47113,33281,438,33719
8/7/2022,Macon,Tennessee,47111,9019,148,9167
8/7/2022,Loudon,Tennessee,47105,15779,195,15974
8/7/2022,Lincoln,Tennessee,47103,10544,177,10721
8/7/2022,Lewis,Tennessee,47101,3728,63,3791
8/7/2022,Lawrence,Tennessee,47099,15168,209,15377
8/7/2022,Lauderdale,Tennessee,47097,8310,109,8419
8/7/2022,Lake,Tennessee,47095,2865,44,2909
8/7/2022,Knox,Tennessee,47093,139882,1445,141327
8/7/2022,Johnson,Tennessee,47091,5459,98,5557
8/7/2022,Jefferson,Tennessee,47089,16927,278,17205
8/7/2022,Jackson,Tennessee,47087,3403,64,3467
8/7/2022,Humphreys,Tennessee,47085,5221,77,5298
8/7/2022,Washington,Nebraska,31177,4926,45,4971
8/7/2022,Wayne,Nebraska,31179,1939,11,1950
8/7/2022,Webster,Nebraska,31181,745,11,756
8/7/2022,Wheeler,Nebraska,31183,125,2,127
8/7/2022,York,Nebraska,31185,4238,21,4259
8/7/2022,Houston,Tennessee,47083,2782,62,2844
8/7/2022,Hickman,Tennessee,47081,7400,113,7513
8/7/2022,Henry,Tennessee,47079,8870,165,9035
8/7/2022,Henderson,Tennessee,47077,9671,167,9838
8/7/2022,Haywood,Tennessee,47075,6790,103,6893
8/7/2022,Hawkins,Tennessee,47073,17878,332,18210
8/7/2022,Hardin,Tennessee,47071,9531,158,9689
8/7/2022,Hardeman,Tennessee,47069,8242,120,8362
8/7/2022,Hancock,Tennessee,47067,2134,39,2173
8/7/2022,Hamilton,Tennessee,47065,110353,1192,111545
8/7/2022,Hamblen,Tennessee,47063,21183,370,21553
8/7/2022,Grundy,Tennessee,47061,4250,75,4325
8/7/2022,Carson City,Nevada,32510,16331,224,16555
8/7/2022,Churchill,Nevada,32001,7193,117,7310
8/7/2022,Clark,Nevada,32003,630324,8791,639115
8/7/2022,Douglas,Nevada,32005,8240,94,8334
8/7/2022,Elko,Nevada,32007,12423,140,12563
8/7/2022,Esmeralda,Nevada,32009,118,4,122
8/7/2022,Eureka,Nevada,32011,173,2,175
8/7/2022,Humboldt,Nevada,32013,2668,58,2726
8/7/2022,Lander,Nevada,32015,1244,21,1265
8/7/2022,Greene,Tennessee,47059,23707,383,24090
8/7/2022,Grainger,Tennessee,47057,7222,111,7333
8/7/2022,Giles,Tennessee,47055,10147,198,10345
8/7/2022,Gibson,Tennessee,47053,18829,265,19094
8/7/2022,Franklin,Tennessee,47051,13789,190,13979
8/7/2022,Fentress,Tennessee,47049,6079,130,6209
8/7/2022,Fayette,Tennessee,47047,12532,191,12723
8/7/2022,Dyer,Tennessee,47045,13827,213,14040
8/7/2022,Dickson,Tennessee,47043,17186,245,17431
8/7/2022,DeKalb,Tennessee,47041,6715,103,6818
8/7/2022,Decatur,Tennessee,47039,3977,71,4048
8/7/2022,Davidson,Tennessee,47037,230959,1725,232684
8/7/2022,Blaine,Oklahoma,40011,2586,44,2630
8/7/2022,Cumberland,Tennessee,47035,17401,335,17736
8/7/2022,Lincoln,Nevada,32017,559,8,567
8/7/2022,Lyon,Nevada,32019,11312,179,11491
8/7/2022,Mineral,Nevada,32021,1397,18,1415
8/7/2022,Nye,Nevada,32023,8382,278,8660
8/7/2022,Pershing,Nevada,32027,2268,31,2299
8/7/2022,Storey,Nevada,32029,165,14,179
8/7/2022,Unknown,Nevada,,8055,1,8056
8/7/2022,Washoe,Nevada,32031,119071,1256,120327
8/7/2022,White Pine,Nevada,32033,1706,22,1728
8/7/2022,Crockett,Tennessee,47033,5540,88,5628
8/7/2022,Coffee,Tennessee,47031,18225,274,18499
8/7/2022,Cocke,Tennessee,47029,12569,228,12797
8/7/2022,Clay,Tennessee,47027,2406,52,2458
8/7/2022,Claiborne,Tennessee,47025,9577,186,9763
8/7/2022,Chester,Tennessee,47023,6275,100,6375
8/7/2022,Cheatham,Tennessee,47021,11687,129,11816
8/7/2022,Carter,Tennessee,47019,17793,343,18136
8/7/2022,Carroll,Tennessee,47017,9845,160,10005
8/7/2022,Belknap,New Hampshire,33001,15481,188,15669
8/7/2022,Carroll,New Hampshire,33003,10920,65,10985
8/7/2022,Wyandot,Ohio,39175,5776,105,5881
8/7/2022,Cheshire,New Hampshire,33005,17018,118,17136
8/7/2022,Coos,New Hampshire,33007,7664,120,7784
8/7/2022,Grafton,New Hampshire,33009,21052,78,21130
8/7/2022,Hillsborough,New Hampshire,33011,109111,944,110055
8/7/2022,Merrimack,New Hampshire,33013,35829,244,36073
8/7/2022,Cannon,Tennessee,47015,4516,68,4584
8/7/2022,Campbell,Tennessee,47013,13352,172,13524
8/7/2022,Bradley,Tennessee,47011,35311,425,35736
8/7/2022,Blount,Tennessee,47009,42516,461,42977
8/7/2022,Bledsoe,Tennessee,47007,4861,61,4922
8/7/2022,Benton,Tennessee,47005,4919,96,5015
8/7/2022,Bedford,Tennessee,47003,15985,241,16226
8/7/2022,Anderson,Tennessee,47001,23969,352,24321
8/7/2022,Ziebach,South Dakota,46137,673,11,684
8/7/2022,Yankton,South Dakota,46135,6246,59,6305
8/7/2022,Walworth,South Dakota,46129,1396,26,1422
8/7/2022,Rockingham,New Hampshire,33015,76273,576,76849
8/7/2022,Strafford,New Hampshire,33017,33442,223,33665
8/7/2022,Sullivan,New Hampshire,33019,10482,72,10554
8/7/2022,Unknown,New Hampshire,,2494,6,2500
8/7/2022,Atlantic,New Jersey,34001,79134,1030,80164
8/7/2022,Bergen,New Jersey,34003,275376,3531,278907
8/7/2022,Burlington,New Jersey,34005,121324,1271,122595
8/7/2022,Union,South Dakota,46127,4125,52,4177
8/7/2022,Turner,South Dakota,46125,2053,62,2115
8/7/2022,Tripp,South Dakota,46123,1468,26,1494
8/7/2022,Todd,South Dakota,46121,3173,52,3225
8/7/2022,Sully,South Dakota,46119,254,3,257
8/7/2022,Stanley,South Dakota,46117,670,8,678
8/7/2022,Camden,New Jersey,34007,146062,1870,147932
8/7/2022,Cape May,New Jersey,34009,25938,315,26253
8/7/2022,Cumberland,New Jersey,34011,44838,624,45462
8/7/2022,Essex,New Jersey,34013,251694,3656,255350
8/7/2022,Gloucester,New Jersey,34015,79899,993,80892
8/7/2022,Spink,South Dakota,46115,1500,36,1536
8/7/2022,Sanborn,South Dakota,46111,616,8,624
8/7/2022,Roberts,South Dakota,46109,2558,53,2611
8/7/2022,Potter,South Dakota,46107,718,7,725
8/7/2022,Perkins,South Dakota,46105,739,18,757
8/7/2022,Hudson,New Jersey,34017,205621,2754,208375
8/7/2022,Hunterdon,New Jersey,34019,29586,283,29869
8/7/2022,Mercer,New Jersey,34021,93693,1292,94985
8/7/2022,Middlesex,New Jersey,34023,234934,2917,237851
8/7/2022,Monmouth,New Jersey,34025,193613,2258,195871
8/7/2022,Morris,New Jersey,34027,143596,1593,145189
8/7/2022,Ocean,New Jersey,34029,186285,3067,189352
8/7/2022,Passaic,New Jersey,34031,166790,2369,169159
8/7/2022,Salem,New Jersey,34033,16037,254,16291
8/7/2022,Somerset,New Jersey,34035,83452,992,84444
8/7/2022,Sussex,New Jersey,34037,39231,506,39737
8/7/2022,Pennington,South Dakota,46103,35428,350,35778
8/7/2022,Oglala Lakota,South Dakota,46102,4197,61,4258
8/7/2022,Moody,South Dakota,46101,1494,28,1522
8/7/2022,Minnehaha,South Dakota,46099,59945,527,60472
8/7/2022,Miner,South Dakota,46097,484,13,497
8/7/2022,Mellette,South Dakota,46095,549,8,557
8/7/2022,Meade,South Dakota,46093,7547,65,7612
8/7/2022,Union,New Jersey,34039,169702,2413,172115
8/7/2022,McPherson,South Dakota,46089,447,9,456
8/7/2022,McCook,South Dakota,46087,1375,31,1406
8/7/2022,Marshall,South Dakota,46091,836,14,850
8/7/2022,Lyman,South Dakota,46085,1287,13,1300
8/7/2022,Lincoln,South Dakota,46083,16212,103,16315
8/7/2022,Unknown,New Jersey,,3108,0,3108
8/7/2022,Warren,New Jersey,34041,27525,347,27872
8/7/2022,Bernalillo,New Mexico,35001,173499,2022,175521
8/7/2022,Catron,New Mexico,35003,467,21,488
8/7/2022,Wood,Ohio,39173,34455,367,34822
8/7/2022,Chaves,New Mexico,35005,23250,349,23599
8/7/2022,Lawrence,South Dakota,46081,7131,85,7216
8/7/2022,Lake,South Dakota,46079,2430,28,2458
8/7/2022,Kingsbury,South Dakota,46077,1386,22,1408
8/7/2022,Jones,South Dakota,46075,183,2,185
8/7/2022,Jerauld,South Dakota,46073,429,20,449
8/7/2022,Jackson,South Dakota,46071,652,21,673
8/7/2022,Hyde,South Dakota,46069,321,8,329
8/7/2022,Hutchinson,South Dakota,46067,1830,36,1866
8/7/2022,Hughes,South Dakota,46065,4586,60,4646
8/7/2022,Cibola,New Mexico,35006,9122,202,9324
8/7/2022,Colfax,New Mexico,35007,2861,68,2929
8/7/2022,Curry,New Mexico,35009,13971,221,14192
8/7/2022,De Baca,New Mexico,35011,634,6,640
8/7/2022,Do�a Ana,New Mexico,35013,70682,860,71542
8/7/2022,Beaver,Oklahoma,40007,1050,11,1061
8/7/2022,Eddy,New Mexico,35015,18152,305,18457
8/7/2022,Grant,New Mexico,35017,8209,105,8314
8/7/2022,Guadalupe,New Mexico,35019,1569,17,1586
8/7/2022,Harding,New Mexico,35021,90,4,94
8/7/2022,Harding,South Dakota,46063,210,3,213
8/7/2022,Hanson,South Dakota,46061,679,6,685
8/7/2022,Hand,South Dakota,46059,610,13,623
8/7/2022,Hamlin,South Dakota,46057,1637,41,1678
8/7/2022,Haakon,South Dakota,46055,486,12,498
8/7/2022,Gregory,South Dakota,46053,1109,34,1143
8/7/2022,Grant,South Dakota,46051,2147,51,2198
8/7/2022,Faulk,South Dakota,46049,605,17,622
8/7/2022,Hidalgo,New Mexico,35023,1197,16,1213
8/7/2022,Lea,New Mexico,35025,21630,382,22012
8/7/2022,Lincoln,New Mexico,35027,5963,68,6031
8/7/2022,Fall River,South Dakota,46047,2092,40,2132
8/7/2022,Edmunds,South Dakota,46045,983,16,999
8/7/2022,Douglas,South Dakota,46043,721,16,737
8/7/2022,Los Alamos,New Mexico,35028,3989,20,4009
8/7/2022,Luna,New Mexico,35029,7454,140,7594
8/7/2022,McKinley,New Mexico,35031,29062,613,29675
8/7/2022,Mora,New Mexico,35033,909,20,929
8/7/2022,Otero,New Mexico,35035,16970,203,17173
8/7/2022,Quay,New Mexico,35037,2251,64,2315
8/7/2022,Rio Arriba,New Mexico,35039,11626,145,11771
8/7/2022,Williams,Ohio,39171,9804,165,9969
8/7/2022,Roosevelt,New Mexico,35041,5538,106,5644
8/7/2022,Sandoval,New Mexico,35043,39684,470,40154
8/7/2022,San Juan,New Mexico,35045,45878,814,46692
8/7/2022,San Miguel,New Mexico,35047,6824,72,6896
8/7/2022,Santa Fe,New Mexico,35049,35747,331,36078
8/7/2022,Dewey,South Dakota,46041,3154,44,3198
8/7/2022,Deuel,South Dakota,46039,1093,12,1105
8/7/2022,Day,South Dakota,46037,1342,35,1377
8/7/2022,Davison,South Dakota,46035,6200,81,6281
8/7/2022,Custer,South Dakota,46033,2245,26,2271
8/7/2022,Sierra,New Mexico,35051,2306,83,2389
8/7/2022,Socorro,New Mexico,35053,4249,93,4342
8/7/2022,Taos,New Mexico,35055,6345,96,6441
8/7/2022,Torrance,New Mexico,35057,3424,59,3483
8/7/2022,Union,New Mexico,35059,1067,17,1084
8/7/2022,Corson,South Dakota,46031,1101,17,1118
8/7/2022,Codington,South Dakota,46029,9130,101,9231
8/7/2022,Clay,South Dakota,46027,3626,23,3649
8/7/2022,Clark,South Dakota,46025,848,10,858
8/7/2022,Charles Mix,South Dakota,46023,3086,35,3121
8/7/2022,Beckham,Oklahoma,40009,6323,107,6430
8/7/2022,Unknown,New Mexico,,249,0,249
8/7/2022,Valencia,New Mexico,35061,21731,292,22023
8/7/2022,Albany,New York,36001,69825,550,70375
8/7/2022,Allegany,New York,36003,9775,159,9934
8/7/2022,Broome,New York,36007,52092,537,52629
8/7/2022,Cattaraugus,New York,36009,17223,227,17450
8/7/2022,Campbell,South Dakota,46021,288,7,295
8/7/2022,Butte,South Dakota,46019,2940,47,2987
8/7/2022,Buffalo,South Dakota,46017,638,18,656
8/7/2022,Brule,South Dakota,46015,1527,22,1549
8/7/2022,Brown,South Dakota,46013,10860,122,10982
8/7/2022,Cayuga,New York,36011,18178,162,18340
8/7/2022,Chautauqua,New York,36013,26427,310,26737
8/7/2022,Chemung,New York,36015,23830,240,24070
8/7/2022,Chenango,New York,36017,10472,125,10597
8/7/2022,Clinton,New York,36019,19722,95,19817
8/7/2022,Columbia,New York,36021,11969,152,12121
8/7/2022,Cortland,New York,36023,11901,127,12028
8/7/2022,Delaware,New York,36025,9012,82,9094
8/7/2022,Dutchess,New York,36027,73998,679,74677
8/7/2022,Erie,New York,36029,243095,2715,245810
8/7/2022,Essex,New York,36031,6739,65,6804
8/7/2022,Franklin,New York,36033,10713,48,10761
8/7/2022,Brookings,South Dakota,46011,8595,57,8652
8/7/2022,Bon Homme,South Dakota,46009,2350,39,2389
8/7/2022,Bennett,South Dakota,46007,823,15,838
8/7/2022,Beadle,South Dakota,46005,4960,61,5021
8/7/2022,Aurora,South Dakota,46003,837,17,854
8/7/2022,Fulton,New York,36035,14423,174,14597
8/7/2022,Genesee,New York,36037,15078,197,15275
8/7/2022,Greene,New York,36039,9769,135,9904
8/7/2022,Hamilton,New York,36041,977,5,982
8/7/2022,Herkimer,New York,36043,15702,197,15899
8/7/2022,Jefferson,New York,36045,23136,142,23278
8/7/2022,Lewis,New York,36049,6666,51,6717
8/7/2022,Livingston,New York,36051,13011,123,13134
8/7/2022,Madison,New York,36053,15048,129,15177
8/7/2022,Monroe,New York,36055,173781,1676,175457
8/7/2022,York,South Carolina,45091,85076,694,85770
8/7/2022,Williamsburg,South Carolina,45089,9254,146,9400
8/7/2022,Union,South Carolina,45087,8391,154,8545
8/7/2022,Sumter,South Carolina,45085,31430,405,31835
8/7/2022,Spartanburg,South Carolina,45083,102688,1565,104253
8/7/2022,Saluda,South Carolina,45081,4154,78,4232
8/7/2022,Richland,South Carolina,45079,139830,968,140798
8/7/2022,Pickens,South Carolina,45077,48858,640,49498
8/7/2022,Montgomery,New York,36057,13389,212,13601
8/7/2022,Nassau,New York,36059,477649,3966,481615
8/7/2022,New York City,New York,,2745335,41215,2786550
8/7/2022,Niagara,New York,36063,54349,599,54948
8/7/2022,Oneida,New York,36065,61635,823,62458
8/7/2022,Onondaga,New York,36067,128369,1105,129474
8/7/2022,Adair,Oklahoma,40001,8655,77,8732
8/7/2022,Ontario,New York,36069,23096,190,23286
8/7/2022,Orangeburg,South Carolina,45075,25952,426,26378
8/7/2022,Oconee,South Carolina,45073,25983,351,26334
8/7/2022,Newberry,South Carolina,45071,14427,202,14629
8/7/2022,McCormick,South Carolina,45065,2405,40,2445
8/7/2022,Marlboro,South Carolina,45069,8746,106,8852
8/7/2022,Marion,South Carolina,45067,9527,166,9693
8/7/2022,Lexington,South Carolina,45063,106815,895,107710
8/7/2022,Orange,New York,36071,121641,983,122624
8/7/2022,Orleans,New York,36073,9571,120,9691
8/7/2022,Oswego,New York,36075,30286,201,30487
8/7/2022,Otsego,New York,36077,11749,97,11846
8/7/2022,Putnam,New York,36079,27518,127,27645
8/7/2022,Rensselaer,New York,36083,37198,277,37475
8/7/2022,Rockland,New York,36087,104949,919,105868
8/7/2022,Lee,South Carolina,45061,4639,96,4735
8/7/2022,Laurens,South Carolina,45059,19978,299,20277
8/7/2022,Lancaster,South Carolina,45057,27740,285,28025
8/7/2022,Kershaw,South Carolina,45055,24058,266,24324
8/7/2022,Jasper,South Carolina,45053,6467,95,6562
8/7/2022,Horry,South Carolina,45051,107812,1192,109004
8/7/2022,Hampton,South Carolina,45049,5389,86,5475
8/7/2022,Greenwood,South Carolina,45047,23836,312,24148
8/7/2022,Greenville,South Carolina,45045,185822,2036,187858
8/7/2022,Saratoga,New York,36091,54675,352,55027
8/7/2022,Schenectady,New York,36093,38876,323,39199
8/7/2022,Schoharie,New York,36095,5784,36,5820
8/7/2022,Schuyler,New York,36097,3956,28,3984
8/7/2022,Seneca,New York,36099,6748,94,6842
8/7/2022,Steuben,New York,36101,22669,259,22928
8/7/2022,St. Lawrence,New York,36089,23699,200,23899
8/7/2022,Suffolk,New York,36103,492922,4524,497446
8/7/2022,Sullivan,New York,36105,21168,133,21301
8/7/2022,Tioga,New York,36107,12439,88,12527
8/7/2022,Georgetown,South Carolina,45043,17386,231,17617
8/7/2022,Florence,South Carolina,45041,45427,648,46075
8/7/2022,Fairfield,South Carolina,45039,6613,110,6723
8/7/2022,Edgefield,South Carolina,45037,7365,72,7437
8/7/2022,Dorchester,South Carolina,45035,62522,511,63033
8/7/2022,Dillon,South Carolina,45033,10530,146,10676
8/7/2022,Darlington,South Carolina,45031,20358,316,20674
8/7/2022,Colleton,South Carolina,45029,9875,222,10097
8/7/2022,Tompkins,New York,36109,23476,90,23566
8/7/2022,Ulster,New York,36111,37256,381,37637
8/7/2022,Warren,New York,36113,16422,132,16554
8/7/2022,Washington,New York,36115,13915,125,14040
8/7/2022,Wayne,New York,36117,19557,190,19747
8/7/2022,Westchester,New York,36119,294833,2778,297611
8/7/2022,Wyoming,New York,36121,9169,85,9254
8/7/2022,Clarendon,South Carolina,45027,9674,163,9837
8/7/2022,Chesterfield,South Carolina,45025,13098,196,13294
8/7/2022,Chester,South Carolina,45023,11018,155,11173
8/7/2022,Cherokee,South Carolina,45021,16005,324,16329
8/7/2022,Charleston,South Carolina,45019,125383,973,126356
8/7/2022,Calhoun,South Carolina,45017,3083,61,3144
8/7/2022,Berkeley,South Carolina,45015,58491,456,58947
8/7/2022,Beaufort,South Carolina,45013,48030,389,48419
8/7/2022,Barnwell,South Carolina,45011,6213,103,6316
8/7/2022,Bamberg,South Carolina,45009,3835,75,3910
8/7/2022,Anderson,South Carolina,45007,61940,1019,62959
8/7/2022,Allendale,South Carolina,45005,2220,24,2244
8/7/2022,Aiken,South Carolina,45003,45775,442,46217
8/7/2022,Abbeville,South Carolina,45001,7003,69,7072
8/7/2022,Yates,New York,36123,3930,40,3970
8/7/2022,Alamance,North Carolina,37001,53006,512,53518
8/7/2022,Alexander,North Carolina,37003,11183,145,11328
8/7/2022,Alleghany,North Carolina,37005,3176,18,3194
8/7/2022,Washington,Rhode Island,44009,38397,243,38640
8/7/2022,Unknown,Rhode Island,,29822,5,29827
8/7/2022,Providence,Rhode Island,44007,248322,2587,250909
8/7/2022,Newport,Rhode Island,44005,23586,97,23683
8/7/2022,Kent,Rhode Island,44003,56437,521,56958
8/7/2022,Bristol,Rhode Island,44001,15913,179,16092
8/7/2022,Anson,North Carolina,37007,7294,101,7395
8/7/2022,Ashe,North Carolina,37009,6724,84,6808
8/7/2022,Avery,North Carolina,37011,4991,45,5036
8/7/2022,Beaufort,North Carolina,37013,14126,179,14305
8/7/2022,Bertie,North Carolina,37015,4707,71,4778
8/7/2022,Bladen,North Carolina,37017,10435,134,10569
8/7/2022,Brunswick,North Carolina,37019,35136,343,35479
8/7/2022,Yauco,Puerto Rico,72153,8900,,8900
8/7/2022,Yabucoa,Puerto Rico,72151,8413,,8413
8/7/2022,Villalba,Puerto Rico,72149,6229,,6229
8/7/2022,Vieques,Puerto Rico,72147,1563,,1563
8/7/2022,Buncombe,North Carolina,37021,61619,630,62249
8/7/2022,Burke,North Carolina,37023,27325,340,27665
8/7/2022,Cabarrus,North Carolina,37025,63177,514,63691
8/7/2022,Caldwell,North Carolina,37027,24713,315,25028
8/7/2022,Camden,North Carolina,37029,1956,9,1965
8/7/2022,Carteret,North Carolina,37031,16230,139,16369
8/7/2022,Caswell,North Carolina,37033,5906,53,5959
8/7/2022,Vega Baja,Puerto Rico,72145,16620,,16620
8/7/2022,Vega Alta,Puerto Rico,72143,10166,,10166
8/7/2022,Utuado,Puerto Rico,72141,6375,,6375
8/7/2022,Unknown,Puerto Rico,,31437,4803,36240
8/7/2022,Trujillo Alto,Puerto Rico,72139,16136,,16136
8/7/2022,Catawba,North Carolina,37035,52576,621,53197
8/7/2022,Chatham,North Carolina,37037,15275,121,15396
8/7/2022,Cherokee,North Carolina,37039,7744,126,7870
8/7/2022,Chowan,North Carolina,37041,4593,62,4655
8/7/2022,Clay,North Carolina,37043,2917,47,2964
8/7/2022,Toa Baja,Puerto Rico,72137,20419,,20419
8/7/2022,Toa Alta,Puerto Rico,72135,18749,,18749
8/7/2022,Santa Isabel,Puerto Rico,72133,5333,,5333
8/7/2022,San Sebastian,Puerto Rico,72131,11280,,11280
8/7/2022,San Lorenzo,Puerto Rico,72129,9674,,9674
8/7/2022,Cleveland,North Carolina,37045,32375,409,32784
8/7/2022,Columbus,North Carolina,37047,17223,274,17497
8/7/2022,Craven,North Carolina,37049,28004,219,28223
8/7/2022,Cumberland,North Carolina,37051,99682,674,100356
8/7/2022,Currituck,North Carolina,37053,5582,38,5620
8/7/2022,Dare,North Carolina,37055,8758,28,8786
8/7/2022,Davidson,North Carolina,37057,47829,444,48273
8/7/2022,Davie,North Carolina,37059,12658,111,12769
8/7/2022,San Juan,Puerto Rico,72127,87335,,87335
8/7/2022,San German,Puerto Rico,72125,7369,,7369
8/7/2022,Salinas,Puerto Rico,72123,6448,,6448
8/7/2022,Sabana Grande,Puerto Rico,72121,5093,,5093
8/7/2022,Rio Grande,Puerto Rico,72119,12046,,12046
8/7/2022,Rincon,Puerto Rico,72117,3568,,3568
8/7/2022,Quebradillas,Puerto Rico,72115,7075,,7075
8/7/2022,Ponce,Puerto Rico,72113,32296,,32296
8/7/2022,Penuelas,Puerto Rico,72111,4576,,4576
8/7/2022,Patillas,Puerto Rico,72109,4274,,4274
8/7/2022,Orocovis,Puerto Rico,72107,5342,,5342
8/7/2022,Duplin,North Carolina,37061,18386,250,18636
8/7/2022,Durham,North Carolina,37063,88942,348,89290
8/7/2022,Edgecombe,North Carolina,37065,15220,158,15378
8/7/2022,Forsyth,North Carolina,37067,106120,857,106977
8/7/2022,Franklin,North Carolina,37069,23328,83,23411
8/7/2022,Gaston,North Carolina,37071,72198,883,73081
8/7/2022,Naranjito,Puerto Rico,72105,8123,,8123
8/7/2022,Naguabo,Puerto Rico,72103,5976,,5976
8/7/2022,Morovis,Puerto Rico,72101,7757,,7757
8/7/2022,Moca,Puerto Rico,72099,10689,,10689
8/7/2022,Mayaguez,Puerto Rico,72097,17841,,17841
8/7/2022,Maunabo,Puerto Rico,72095,2572,,2572
8/7/2022,Maricao,Puerto Rico,72093,1211,,1211
8/7/2022,Manati,Puerto Rico,72091,10293,,10293
8/7/2022,Gates,North Carolina,37073,2118,20,2138
8/7/2022,Luquillo,Puerto Rico,72089,4408,,4408
8/7/2022,Loiza,Puerto Rico,72087,4977,,4977
8/7/2022,Graham,North Carolina,37075,2495,31,2526
8/7/2022,Granville,North Carolina,37077,16684,118,16802
8/7/2022,Greene,North Carolina,37079,6393,72,6465
8/7/2022,Guilford,North Carolina,37081,136438,1272,137710
8/7/2022,Halifax,North Carolina,37083,15838,190,16028
8/7/2022,Harnett,North Carolina,37085,37369,348,37717
8/7/2022,Las Piedras,Puerto Rico,72085,9725,,9725
8/7/2022,Las Marias,Puerto Rico,72083,2383,,2383
8/7/2022,Lares,Puerto Rico,72081,8193,,8193
8/7/2022,Lajas,Puerto Rico,72079,5455,,5455
8/7/2022,Juncos,Puerto Rico,72077,10626,,10626
8/7/2022,Haywood,North Carolina,37087,14702,231,14933
8/7/2022,Henderson,North Carolina,37089,28113,334,28447
8/7/2022,Hertford,North Carolina,37091,5440,90,5530
8/7/2022,Hoke,North Carolina,37093,16896,125,17021
8/7/2022,Hyde,North Carolina,37095,1501,14,1515
8/7/2022,Iredell,North Carolina,37097,53761,484,54245
8/7/2022,Jackson,North Carolina,37099,10675,101,10776
8/7/2022,Johnston,North Carolina,37101,66635,465,67100
8/7/2022,Alfalfa,Oklahoma,40003,1736,16,1752
8/7/2022,Juana Diaz,Puerto Rico,72075,11627,,11627
8/7/2022,Jayuya,Puerto Rico,72073,4388,,4388
8/7/2022,Isabela,Puerto Rico,72071,11555,,11555
8/7/2022,Humacao,Puerto Rico,72069,13598,,13598
8/7/2022,Hormigueros,Puerto Rico,72067,3968,,3968
8/7/2022,Jones,North Carolina,37103,2498,41,2539
8/7/2022,Lee,North Carolina,37105,17716,158,17874
8/7/2022,Lenoir,North Carolina,37107,17537,235,17772
8/7/2022,Lincoln,North Carolina,37109,26744,185,26929
8/7/2022,Macon,North Carolina,37113,8762,123,8885
8/7/2022,Madison,North Carolina,37115,5698,82,5780
8/7/2022,Martin,North Carolina,37117,6829,95,6924
8/7/2022,McDowell,North Carolina,37111,15147,178,15325
8/7/2022,Mecklenburg,North Carolina,37119,322049,1690,323739
8/7/2022,Hatillo,Puerto Rico,72065,9348,,9348
8/7/2022,Gurabo,Puerto Rico,72063,12234,,12234
8/7/2022,Guaynabo,Puerto Rico,72061,25700,,25700
8/7/2022,Guayanilla,Puerto Rico,72059,4545,,4545
8/7/2022,Guayama,Puerto Rico,72057,9389,,9389
8/7/2022,Guanica,Puerto Rico,72055,2858,,2858
8/7/2022,Florida,Puerto Rico,72054,4003,,4003
8/7/2022,Fajardo,Puerto Rico,72053,8079,,8079
8/7/2022,Mitchell,North Carolina,37121,4025,39,4064
8/7/2022,Montgomery,North Carolina,37123,7865,135,8000
8/7/2022,Moore,North Carolina,37125,27292,334,27626
8/7/2022,Nash,North Carolina,37127,28965,328,29293
8/7/2022,New Hanover,North Carolina,37129,57382,409,57791
8/7/2022,Northampton,North Carolina,37131,4971,88,5059
8/7/2022,Onslow,North Carolina,37133,58046,392,58438
8/7/2022,Orange,North Carolina,37135,33547,142,33689
8/7/2022,Dorado,Puerto Rico,72051,10716,,10716
8/7/2022,Culebra,Puerto Rico,72049,404,,404
8/7/2022,Corozal,Puerto Rico,72047,10178,,10178
8/7/2022,Comerio,Puerto Rico,72045,4958,,4958
8/7/2022,Coamo,Puerto Rico,72043,9389,,9389
8/7/2022,Cidra,Puerto Rico,72041,11299,,11299
8/7/2022,Ciales,Puerto Rico,72039,4318,,4318
8/7/2022,Ceiba,Puerto Rico,72037,2685,,2685
8/7/2022,Cayey,Puerto Rico,72035,11557,,11557
8/7/2022,Catano,Puerto Rico,72033,6261,,6261
8/7/2022,Carolina,Puerto Rico,72031,43467,,43467
8/7/2022,Canovanas,Puerto Rico,72029,10855,,10855
8/7/2022,Pamlico,North Carolina,37137,3008,31,3039
8/7/2022,Pasquotank,North Carolina,37139,9357,129,9486
8/7/2022,Pender,North Carolina,37141,16729,133,16862
8/7/2022,Perquimans,North Carolina,37143,3053,25,3078
8/7/2022,Person,North Carolina,37145,10733,111,10844
8/7/2022,Pitt,North Carolina,37147,59118,258,59376
8/7/2022,Camuy,Puerto Rico,72027,8845,,8845
8/7/2022,Caguas,Puerto Rico,72025,36365,,36365
8/7/2022,Cabo Rojo,Puerto Rico,72023,10513,,10513
8/7/2022,Bayamon,Puerto Rico,72021,55118,,55118
8/7/2022,Barranquitas,Puerto Rico,72019,8002,,8002
8/7/2022,Barceloneta,Puerto Rico,72017,6144,,6144
8/7/2022,Arroyo,Puerto Rico,72015,4341,,4341
8/7/2022,Arecibo,Puerto Rico,72013,21578,,21578
8/7/2022,Anasco,Puerto Rico,72011,6612,,6612
8/7/2022,Aibonito,Puerto Rico,72009,6625,,6625
8/7/2022,Polk,North Carolina,37149,4317,68,4385
8/7/2022,Randolph,North Carolina,37151,38735,464,39199
8/7/2022,Richmond,North Carolina,37153,14480,195,14675
8/7/2022,Robeson,North Carolina,37155,45308,556,45864
8/7/2022,Aguas Buenas,Puerto Rico,72007,6795,,6795
8/7/2022,Aguadilla,Puerto Rico,72005,12823,,12823
8/7/2022,Aguada,Puerto Rico,72003,10556,,10556
8/7/2022,Adjuntas,Puerto Rico,72001,5054,,5054
8/7/2022,Rockingham,North Carolina,37157,24099,304,24403
8/7/2022,Rowan,North Carolina,37159,45355,600,45955
8/7/2022,York,Pennsylvania,42133,129599,1539,131138
8/7/2022,Wyoming,Pennsylvania,42131,5705,114,5819
8/7/2022,Westmoreland,Pennsylvania,42129,87711,1422,89133
8/7/2022,Wayne,Pennsylvania,42127,11313,177,11490
8/7/2022,Rutherford,North Carolina,37161,19065,409,19474
8/7/2022,Washington,Pennsylvania,42125,56619,672,57291
8/7/2022,Warren,Pennsylvania,42123,8179,219,8398
8/7/2022,Venango,Pennsylvania,42121,12196,249,12445
8/7/2022,Union,Pennsylvania,42119,12478,156,12634
8/7/2022,Tioga,Pennsylvania,42117,8899,200,9099
8/7/2022,Sampson,North Carolina,37163,20645,189,20834
8/7/2022,Scotland,North Carolina,37165,11198,136,11334
8/7/2022,Stanly,North Carolina,37167,21050,271,21321
8/7/2022,Stokes,North Carolina,37169,12598,186,12784
8/7/2022,Surry,North Carolina,37171,23673,368,24041
8/7/2022,Susquehanna,Pennsylvania,42115,8785,116,8901
8/7/2022,Sullivan,Pennsylvania,42113,1200,36,1236
8/7/2022,Somerset,Pennsylvania,42111,20058,415,20473
8/7/2022,Snyder,Pennsylvania,42109,8684,160,8844
8/7/2022,Schuylkill,Pennsylvania,42107,37259,700,37959
8/7/2022,Potter,Pennsylvania,42105,3453,94,3547
8/7/2022,Pike,Pennsylvania,42103,11473,103,11576
8/7/2022,Philadelphia,Pennsylvania,42101,349958,5219,355177
8/7/2022,Perry,Pennsylvania,42099,9436,190,9626
8/7/2022,Northumberland,Pennsylvania,42097,24963,550,25513
8/7/2022,Swain,North Carolina,37173,4171,49,4220
8/7/2022,Transylvania,North Carolina,37175,6940,78,7018
8/7/2022,Tyrrell,North Carolina,37177,1078,9,1087
8/7/2022,Union,North Carolina,37179,69436,504,69940
8/7/2022,Vance,North Carolina,37181,13532,126,13658
8/7/2022,Wake,North Carolina,37183,348866,1189,350055
8/7/2022,Warren,North Carolina,37185,4946,47,4993
8/7/2022,Washington,North Carolina,37187,3355,52,3407
8/7/2022,Northampton,Pennsylvania,42095,88225,1138,89363
8/7/2022,Montour,Pennsylvania,42093,5138,94,5232
8/7/2022,Montgomery,Pennsylvania,42091,176174,2407,178581
8/7/2022,Monroe,Pennsylvania,42089,41787,547,42334
8/7/2022,Mifflin,Pennsylvania,42087,13151,283,13434
8/7/2022,Watauga,North Carolina,37189,13053,72,13125
8/7/2022,Wayne,North Carolina,37191,35437,417,35854
8/7/2022,Wilkes,North Carolina,37193,19443,276,19719
8/7/2022,Wilson,North Carolina,37195,24158,329,24487
8/7/2022,Yadkin,North Carolina,37197,12420,122,12542
8/7/2022,Yancey,North Carolina,37199,5794,60,5854
8/7/2022,Adams,North Dakota,38001,631,10,641
8/7/2022,Barnes,North Dakota,38003,3198,47,3245
8/7/2022,Benson,North Dakota,38005,2105,23,2128
8/7/2022,Mercer,Pennsylvania,42085,25312,510,25822
8/7/2022,McKean,Pennsylvania,42083,8725,152,8877
8/7/2022,Lycoming,Pennsylvania,42081,31019,548,31567
8/7/2022,Luzerne,Pennsylvania,42079,82026,1448,83474
8/7/2022,Lehigh,Pennsylvania,42077,98797,1282,100079
8/7/2022,Lebanon,Pennsylvania,42075,39832,528,40360
8/7/2022,Lawrence,Pennsylvania,42073,20471,429,20900
8/7/2022,Lancaster,Pennsylvania,42071,131953,1947,133900
8/7/2022,Lackawanna,Pennsylvania,42069,50054,810,50864
8/7/2022,Billings,North Dakota,38007,159,1,160
8/7/2022,Bottineau,North Dakota,38009,1723,26,1749
8/7/2022,Bowman,North Dakota,38011,877,9,886
8/7/2022,Burke,North Dakota,38013,457,3,460
8/7/2022,Burleigh,North Dakota,38015,37477,303,37780
8/7/2022,Cass,North Dakota,38017,64442,333,64775
8/7/2022,Cavalier,North Dakota,38019,896,7,903
8/7/2022,Dickey,North Dakota,38021,1624,39,1663
8/7/2022,Divide,North Dakota,38023,514,4,518
8/7/2022,Dunn,North Dakota,38025,1100,8,1108
8/7/2022,Eddy,North Dakota,38027,813,6,819
8/7/2022,Emmons,North Dakota,38029,760,18,778
8/7/2022,Juniata,Pennsylvania,42067,5087,183,5270
8/7/2022,Jefferson,Pennsylvania,42065,9718,246,9964
8/7/2022,Indiana,Pennsylvania,42063,19050,371,19421
8/7/2022,Huntingdon,Pennsylvania,42061,12288,258,12546
8/7/2022,Greene,Pennsylvania,42059,9200,108,9308
8/7/2022,Foster,North Dakota,38031,1045,23,1068
8/7/2022,Golden Valley,North Dakota,38033,491,4,495
8/7/2022,Fulton,Pennsylvania,42057,4412,66,4478
8/7/2022,Franklin,Pennsylvania,42055,44098,718,44816
8/7/2022,Forest,Pennsylvania,42053,2378,36,2414
8/7/2022,Fayette,Pennsylvania,42051,33919,694,34613
8/7/2022,Erie,Pennsylvania,42049,63248,799,64047
8/7/2022,Elk,Pennsylvania,42047,7650,107,7757
8/7/2022,Delaware,Pennsylvania,42045,125270,1909,127179
8/7/2022,Dauphin,Pennsylvania,42043,64515,992,65507
8/7/2022,Grand Forks,North Dakota,38035,24119,125,24244
8/7/2022,Grant,North Dakota,38037,492,11,503
8/7/2022,Griggs,North Dakota,38039,629,2,631
8/7/2022,Hettinger,North Dakota,38041,859,8,867
8/7/2022,Kidder,North Dakota,38043,544,13,557
8/7/2022,Cumberland,Pennsylvania,42041,56102,917,57019
8/7/2022,Crawford,Pennsylvania,42039,21598,335,21933
8/7/2022,Columbia,Pennsylvania,42037,16870,253,17123
8/7/2022,Clinton,Pennsylvania,42035,9867,130,9997
8/7/2022,Clearfield,Pennsylvania,42033,21003,359,21362
8/7/2022,Clarion,Pennsylvania,42031,8834,209,9043
8/7/2022,Chester,Pennsylvania,42029,104725,1198,105923
8/7/2022,LaMoure,North Dakota,38045,1068,20,1088
8/7/2022,Logan,North Dakota,38047,463,12,475
8/7/2022,Centre,Pennsylvania,42027,39068,362,39430
8/7/2022,Carbon,Pennsylvania,42025,17481,313,17794
8/7/2022,Cameron,Pennsylvania,42023,894,21,915
8/7/2022,Cambria,Pennsylvania,42021,37607,753,38360
8/7/2022,Butler,Pennsylvania,42019,49007,761,49768
8/7/2022,Bucks,Pennsylvania,42017,138415,1984,140399
8/7/2022,Bradford,Pennsylvania,42015,17558,214,17772
8/7/2022,Blair,Pennsylvania,42013,31607,638,32245
8/7/2022,Berks,Pennsylvania,42011,111612,1639,113251
8/7/2022,McHenry,North Dakota,38049,1417,31,1448
8/7/2022,McIntosh,North Dakota,38051,746,9,755
8/7/2022,McKenzie,North Dakota,38053,3420,25,3445
8/7/2022,McLean,North Dakota,38055,2899,49,2948
8/7/2022,Mercer,North Dakota,38057,2745,24,2769
8/7/2022,Morton,North Dakota,38059,11996,142,12138
8/7/2022,Mountrail,North Dakota,38061,3507,37,3544
8/7/2022,Nelson,North Dakota,38063,811,18,829
8/7/2022,Bedford,Pennsylvania,42009,11627,281,11908
8/7/2022,Beaver,Pennsylvania,42007,43988,764,44752
8/7/2022,Armstrong,Pennsylvania,42005,16390,356,16746
8/7/2022,Allegheny,Pennsylvania,42003,302293,3449,305742
8/7/2022,Adams,Pennsylvania,42001,27330,384,27714
8/7/2022,Yamhill,Oregon,41071,20470,233,20703
8/7/2022,Oliver,North Dakota,38065,343,5,348
8/7/2022,Pembina,North Dakota,38067,2144,16,2160
8/7/2022,Pierce,North Dakota,38069,1123,32,1155
8/7/2022,Ramsey,North Dakota,38071,3885,57,3942
8/7/2022,Ransom,North Dakota,38073,1631,28,1659
8/7/2022,Renville,North Dakota,38075,586,15,601
8/7/2022,Richland,North Dakota,38077,4333,23,4356
8/7/2022,Rolette,North Dakota,38079,6897,43,6940
8/7/2022,Sargent,North Dakota,38081,1116,9,1125
8/7/2022,Sheridan,North Dakota,38083,311,7,318
8/7/2022,Wheeler,Oregon,41069,258,3,261
8/7/2022,Washington,Oregon,41067,109036,669,109705
8/7/2022,Wasco,Oregon,41065,6072,68,6140
8/7/2022,Wallowa,Oregon,41063,1391,17,1408
8/7/2022,Unknown,Oregon,,5,0,5
8/7/2022,Union,Oregon,41061,5464,85,5549
8/7/2022,Umatilla,Oregon,41059,24327,238,24565
8/7/2022,Tillamook,Oregon,41057,4507,69,4576
8/7/2022,Sherman,Oregon,41055,362,6,368
8/7/2022,Sioux,North Dakota,38085,1450,19,1469
8/7/2022,Slope,North Dakota,38087,67,0,67
8/7/2022,Stark,North Dakota,38089,12416,86,12502
8/7/2022,Polk,Oregon,41053,18273,144,18417
8/7/2022,Multnomah,Oregon,41051,150860,1327,152187
8/7/2022,Morrow,Oregon,41049,3167,37,3204
8/7/2022,Marion,Oregon,41047,79651,769,80420
8/7/2022,Malheur,Oregon,41045,8835,110,8945
8/7/2022,Linn,Oregon,41043,30216,294,30510
8/7/2022,Lincoln,Oregon,41041,8334,97,8431
8/7/2022,Lane,Oregon,41039,70218,595,70813
8/7/2022,Lake,Oregon,41037,1537,30,1567
8/7/2022,Klamath,Oregon,41035,16157,238,16395
8/7/2022,Josephine,Oregon,41033,18478,356,18834
8/7/2022,Jefferson,Oregon,41031,8097,100,8197
8/7/2022,Jackson,Oregon,41029,49075,566,49641
8/7/2022,Hood River,Oregon,41027,4265,46,4311
8/7/2022,Harney,Oregon,41025,1746,41,1787
8/7/2022,Steele,North Dakota,38091,397,2,399
8/7/2022,Stutsman,North Dakota,38093,7573,97,7670
8/7/2022,Towner,North Dakota,38095,680,12,692
8/7/2022,Traill,North Dakota,38097,2282,26,2308
8/7/2022,Unknown,North Dakota,,0,134,134
8/7/2022,Walsh,North Dakota,38099,3657,34,3691
8/7/2022,Ward,North Dakota,38101,22102,251,22353
8/7/2022,Wells,North Dakota,38103,1090,12,1102
8/7/2022,Williams,North Dakota,38105,11160,68,11228
8/7/2022,Rota,Northern Mariana Islands,69100,418,0,418
8/7/2022,Grant,Oregon,41023,2006,22,2028
8/7/2022,Atoka,Oklahoma,40005,4166,54,4220
8/7/2022,Gilliam,Oregon,41021,294,6,300
8/7/2022,Douglas,Oregon,41019,23136,423,23559
8/7/2022,Deschutes,Oregon,41017,55685,318,56003
8/7/2022,Curry,Oregon,41015,4119,62,4181
8/7/2022,Crook,Oregon,41013,7080,86,7166
8/7/2022,Saipan,Northern Mariana Islands,69110,11942,38,11980
8/7/2022,Tinian,Northern Mariana Islands,69120,372,0,372
8/7/2022,Adams,Ohio,39001,7744,153,7897
8/7/2022,Allen,Ohio,39003,29503,481,29984
8/7/2022,Ashland,Ohio,39005,13047,221,13268
8/7/2022,Ashtabula,Ohio,39007,22192,438,22630
8/7/2022,Athens,Ohio,39009,16782,147,16929
8/7/2022,Auglaize,Ohio,39011,12479,190,12669
8/7/2022,Belmont,Ohio,39013,17104,319,17423
8/7/2022,Coos,Oregon,41011,12735,168,12903
8/7/2022,Columbia,Oregon,41009,9227,104,9331
8/7/2022,Clatsop,Oregon,41007,5693,55,5748
8/7/2022,Clackamas,Oregon,41005,74917,700,75617
8/7/2022,Benton,Oregon,41003,19580,76,19656
8/7/2022,Baker,Oregon,41001,3523,53,3576
8/7/2022,Woodward,Oklahoma,40153,5461,79,5540
8/7/2022,Brown,Ohio,39015,12175,186,12361
8/7/2022,Butler,Ohio,39017,102085,1176,103261
8/7/2022,Carroll,Ohio,39019,5692,129,5821
8/7/2022,Champaign,Ohio,39021,9535,150,9685
8/7/2022,Clark,Ohio,39023,38191,592,38783
8/7/2022,Clermont,Ohio,39025,57076,566,57642
8/7/2022,Woods,Oklahoma,40151,2459,38,2497
8/7/2022,Washita,Oklahoma,40149,2805,56,2861
8/7/2022,Washington,Oklahoma,40147,13737,264,14001
8/7/2022,Wagoner,Oklahoma,40145,23865,278,24143
8/7/2022,Unknown,Oklahoma,,4528,0,4528
8/7/2022,Tulsa,Oklahoma,40143,187141,2210,189351
8/7/2022,Clinton,Ohio,39027,11227,171,11398
8/7/2022,Columbiana,Ohio,39029,26410,490,26900
8/7/2022,Coshocton,Ohio,39031,8768,161,8929
8/7/2022,Crawford,Ohio,39033,12335,218,12553
8/7/2022,Cuyahoga,Ohio,39035,303462,3871,307333
8/7/2022,Darke,Ohio,39037,13442,242,13684
8/7/2022,Defiance,Ohio,39039,10866,167,11033
8/7/2022,Delaware,Ohio,39041,50229,276,50505
8/7/2022,Erie,Ohio,39043,21624,270,21894
8/7/2022,Fairfield,Ohio,39045,42257,437,42694
8/7/2022,Fayette,Ohio,39047,8404,123,8527
8/7/2022,Franklin,Ohio,39049,326008,2654,328662
8/7/2022,Fulton,Ohio,39051,11108,180,11288
8/7/2022,Tillman,Oklahoma,40141,1641,36,1677
8/7/2022,Texas,Oklahoma,40139,6307,56,6363
8/7/2022,Stephens,Oklahoma,40137,12040,209,12249
8/7/2022,Sequoyah,Oklahoma,40135,11604,107,11711
8/7/2022,Seminole,Oklahoma,40133,6709,136,6845
8/7/2022,Rogers,Oklahoma,40131,27532,393,27925
8/7/2022,Roger Mills,Oklahoma,40129,950,16,966
8/7/2022,Pushmataha,Oklahoma,40127,2860,45,2905
8/7/2022,Gallia,Ohio,39053,8739,130,8869
8/7/2022,Geauga,Ohio,39055,17772,270,18042
8/7/2022,Greene,Ohio,39057,42308,519,42827
8/7/2022,Guernsey,Ohio,39059,11610,156,11766
8/7/2022,Hamilton,Ohio,39061,210594,2098,212692
8/7/2022,Hancock,Ohio,39063,18538,278,18816
8/7/2022,Hardin,Ohio,39065,7622,161,7783
8/7/2022,Harrison,Ohio,39067,3534,74,3608
8/7/2022,Henry,Ohio,39069,6896,108,7004
8/7/2022,Highland,Ohio,39071,11664,185,11849
8/7/2022,Pottawatomie,Oklahoma,40125,22590,285,22875
8/7/2022,Pontotoc,Oklahoma,40123,13507,155,13662
8/7/2022,Pittsburg,Oklahoma,40121,11786,218,12004
8/7/2022,Payne,Oklahoma,40119,20107,170,20277
8/7/2022,Pawnee,Oklahoma,40117,4439,85,4524
8/7/2022,Ottawa,Oklahoma,40115,10143,127,10270
8/7/2022,Hocking,Ohio,39073,7335,125,7460
8/7/2022,Osage,Oklahoma,40113,11977,171,12148
8/7/2022,Okmulgee,Oklahoma,40111,10325,193,10518
8/7/2022,Holmes,Ohio,39075,5352,185,5537
8/7/2022,Huron,Ohio,39077,15775,225,16000
8/7/2022,Jackson,Ohio,39079,10057,142,10199
8/7/2022,Jefferson,Ohio,39081,16385,326,16711
8/7/2022,Knox,Ohio,39083,14628,232,14860
8/7/2022,Oklahoma,Oklahoma,40109,217274,2512,219786
8/7/2022,Okfuskee,Oklahoma,40107,3763,62,3825
8/7/2022,Nowata,Oklahoma,40105,2929,42,2971
8/7/2022,Noble,Oklahoma,40103,3235,41,3276
8/7/2022,Muskogee,Oklahoma,40101,21564,353,21917
8/7/2022,Murray,Oklahoma,40099,4504,79,4583
8/7/2022,McIntosh,Oklahoma,40091,5200,126,5326
8/7/2022,McCurtain,Oklahoma,40089,8529,166,8695
8/7/2022,McClain,Oklahoma,40087,12566,139,12705
8/7/2022,Mayes,Oklahoma,40097,11306,165,11471
8/7/2022,Marshall,Oklahoma,40095,4955,46,5001
8/7/2022,Major,Oklahoma,40093,2619,41,2660
8/7/2022,Love,Oklahoma,40085,3360,40,3400
8/7/2022,Lake,Ohio,39085,54042,747,54789
8/7/2022,Lawrence,Ohio,39087,20340,262,20602
8/7/2022,Licking,Ohio,39089,46182,482,46664
8/7/2022,Logan,Ohio,39091,11173,174,11347
8/7/2022,Lorain,Ohio,39093,75968,997,76965
8/7/2022,Lucas,Ohio,39095,111413,1438,112851
8/7/2022,Madison,Ohio,39097,10398,139,10537
8/7/2022,Mahoning,Ohio,39099,58892,1104,59996
8/7/2022,Marion,Ohio,39101,21693,274,21967
8/7/2022,Medina,Ohio,39103,44508,518,45026
8/7/2022,Meigs,Ohio,39105,5242,91,5333
8/7/2022,Logan,Oklahoma,40083,11940,165,12105
8/7/2022,Lincoln,Oklahoma,40081,8595,144,8739
8/21/2022,Polk,Iowa,19153,137411,1142,138553
8/21/2022,Pocahontas,Iowa,19151,1772,27,1799
8/21/2022,Plymouth,Iowa,19149,6652,105,6757
8/21/2022,Palo Alto,Iowa,19147,2190,38,2228
8/21/2022,Page,Iowa,19145,3523,49,3572
8/21/2022,Osceola,Iowa,19143,1438,22,1460
8/21/2022,Parmer,Texas,48369,2515,53,2568
8/21/2022,O'Brien,Iowa,19141,3628,72,3700
8/21/2022,Muscatine,Iowa,19139,10454,132,10586
8/21/2022,Montgomery,Iowa,19137,2382,56,2438
8/21/2022,Pecos,Texas,48371,3164,71,3235
8/21/2022,Monroe,Iowa,19135,2024,51,2075
8/21/2022,Pending County Assignment,Texas,,65,0,65
8/21/2022,Monona,Iowa,19133,1868,51,1919
8/21/2022,Mitchell,Iowa,19131,2649,49,2698
8/21/2022,Mills,Iowa,19129,3677,45,3722
8/21/2022,Marshall,Iowa,19127,10420,116,10536
8/21/2022,Marion,Iowa,19125,8150,127,8277
8/21/2022,Mahaska,Iowa,19123,5329,91,5420
8/21/2022,Madison,Iowa,19121,3376,42,3418
8/21/2022,Lyon,Iowa,19119,2877,52,2929
8/21/2022,Lucas,Iowa,19117,1919,32,1951
8/21/2022,Louisa,Iowa,19115,2714,63,2777
8/21/2022,Linn,Iowa,19113,58742,612,59354
8/21/2022,Lee,Iowa,19111,8396,143,8539
8/21/2022,Kossuth,Iowa,19109,4083,90,4173
8/21/2022,Keokuk,Iowa,19107,2231,49,2280
8/21/2022,Jones,Iowa,19105,5986,76,6062
8/21/2022,Johnson,Iowa,19103,40720,157,40877
8/21/2022,Jefferson,Iowa,19101,3842,53,3895
8/21/2022,Jasper,Iowa,19099,9513,116,9629
8/21/2022,Jackson,Iowa,19097,5082,71,5153
8/21/2022,Polk,Texas,48373,8612,254,8866
8/21/2022,Iowa,Iowa,19095,4004,50,4054
8/21/2022,Ida,Iowa,19093,1936,49,1985
8/21/2022,Humboldt,Iowa,19091,2824,38,2862
8/21/2022,Salem city,Virginia,51775,6487,100,6587
8/21/2022,Potter,Texas,48375,39002,752,39754
8/21/2022,Asotin,Washington,53003,5007,72,5079
8/21/2022,Presidio,Texas,48377,1082,39,1121
8/21/2022,Benton,Washington,53005,58319,499,58818
8/21/2022,Howard,Iowa,19089,2192,37,2229
8/21/2022,Henry,Iowa,19087,5997,77,6074
8/21/2022,Harrison,Iowa,19085,3594,95,3689
8/21/2022,Hardin,Iowa,19083,4528,63,4591
8/21/2022,Hancock,Iowa,19081,3072,49,3121
8/21/2022,Hamilton,Iowa,19079,3681,78,3759
8/21/2022,Chelan,Washington,53007,22717,180,22897
8/21/2022,Guthrie,Iowa,19077,2536,47,2583
8/21/2022,Grundy,Iowa,19075,2757,45,2802
8/21/2022,Greene,Iowa,19073,1863,23,1886
8/21/2022,Fremont,Iowa,19071,1502,26,1528
8/21/2022,Franklin,Iowa,19069,2732,44,2776
8/21/2022,Floyd,Iowa,19067,3927,63,3990
8/21/2022,Fayette,Iowa,19065,4496,78,4574
8/21/2022,Emmet,Iowa,19063,2478,54,2532
8/21/2022,Dubuque,Iowa,19061,28566,304,28870
8/21/2022,Dickinson,Iowa,19059,4384,76,4460
8/21/2022,Des Moines,Iowa,19057,10102,146,10248
8/21/2022,Delaware,Iowa,19055,4396,68,4464
8/21/2022,Decatur,Iowa,19053,1666,28,1694
8/21/2022,Davis,Iowa,19051,1700,34,1734
8/21/2022,Rains,Texas,48379,2023,59,2082
8/21/2022,Randall,Texas,48381,41353,525,41878
8/21/2022,Dallas,Iowa,19049,25211,149,25360
8/21/2022,Crawford,Iowa,19047,4694,54,4748
8/21/2022,Clinton,Iowa,19045,12719,150,12869
8/21/2022,Clayton,Iowa,19043,3747,75,3822
8/21/2022,Clay,Iowa,19041,4436,45,4481
8/21/2022,Reagan,Texas,48383,931,14,945
8/21/2022,Clarke,Iowa,19039,2477,41,2518
8/21/2022,Chickasaw,Iowa,19037,2926,34,2960
8/21/2022,Cherokee,Iowa,19035,3272,68,3340
8/21/2022,Cerro Gordo,Iowa,19033,11967,172,12139
8/21/2022,Cedar,Iowa,19031,4586,37,4623
8/21/2022,Cass,Iowa,19029,3073,79,3152
8/21/2022,Carroll,Iowa,19027,5311,74,5385
8/21/2022,Real,Texas,48385,931,25,956
8/21/2022,Calhoun,Iowa,19025,2820,26,2846
8/21/2022,Butler,Iowa,19023,3495,55,3550
8/21/2022,Buena Vista,Iowa,19021,6640,59,6699
8/21/2022,Buchanan,Iowa,19019,5104,62,5166
8/21/2022,Bremer,Iowa,19017,5969,85,6054
8/21/2022,Boone,Iowa,19015,5972,59,6031
8/21/2022,Black Hawk,Iowa,19013,35985,495,36480
8/21/2022,Benton,Iowa,19011,6573,80,6653
8/21/2022,Audubon,Iowa,19009,1186,21,1207
8/21/2022,Appanoose,Iowa,19007,3094,70,3164
8/21/2022,Red River,Texas,48387,2504,69,2573
8/21/2022,Allamakee,Iowa,19005,3032,62,3094
8/21/2022,Adams,Iowa,19003,863,14,877
8/21/2022,Reeves,Texas,48389,5083,75,5158
8/21/2022,Adair,Iowa,19001,1676,51,1727
8/21/2022,Refugio,Texas,48391,2027,38,2065
8/21/2022,Roberts,Texas,48393,184,2,186
8/21/2022,Whitley,Indiana,18183,10374,86,10460
8/21/2022,Robertson,Texas,48395,4929,77,5006
8/21/2022,White,Indiana,18181,7574,98,7672
8/21/2022,Wells,Indiana,18179,6975,134,7109
8/21/2022,Wayne,Indiana,18177,21122,345,21467
8/21/2022,Washington,Indiana,18175,6505,89,6594
8/21/2022,Lancaster,Virginia,51103,2083,36,2119
8/21/2022,Warrick,Indiana,18173,22560,245,22805
8/21/2022,Warren,Indiana,18171,2243,30,2273
8/21/2022,Wabash,Indiana,18169,9432,162,9594
8/21/2022,Vigo,Indiana,18167,31921,419,32340
8/21/2022,Vermillion,Indiana,18165,4538,80,4618
8/21/2022,Vanderburgh,Indiana,18163,64220,646,64866
8/21/2022,Unknown,Indiana,,0,72,72
8/21/2022,Union,Indiana,18161,2142,22,2164
8/21/2022,Brooke,West Virginia,54009,5640,106,5746
8/21/2022,Rockwall,Texas,48397,29247,270,29517
8/21/2022,Scott,Virginia,51169,6505,115,6620
8/21/2022,Juneau,Wisconsin,55057,8556,70,8626
8/21/2022,Cabell,West Virginia,54011,31281,397,31678
8/21/2022,Calhoun,West Virginia,54013,2087,15,2102
8/21/2022,Lincoln,Washington,53043,2477,29,2506
8/21/2022,Bayfield,Wisconsin,55007,3975,42,4017
8/21/2022,Runnels,Texas,48399,2570,68,2638
8/21/2022,Rusk,Texas,48401,11675,235,11910
8/21/2022,Tipton,Indiana,18159,3768,89,3857
8/21/2022,Tippecanoe,Indiana,18157,56401,421,56822
8/21/2022,Switzerland,Indiana,18155,2414,20,2434
8/21/2022,Sullivan,Indiana,18153,5808,77,5885
8/21/2022,St. Joseph,Indiana,18141,77602,903,78505
8/21/2022,Steuben,Indiana,18151,10512,122,10634
8/21/2022,Starke,Indiana,18149,5154,104,5258
8/21/2022,Spencer,Indiana,18147,5631,61,5692
8/21/2022,Shelby,Indiana,18145,15235,185,15420
8/21/2022,Scott,Indiana,18143,8676,110,8786
8/21/2022,Rush,Indiana,18139,5341,59,5400
8/21/2022,Ripley,Indiana,18137,9054,141,9195
8/21/2022,Randolph,Indiana,18135,6419,152,6571
8/21/2022,Putnam,Indiana,18133,10210,131,10341
8/21/2022,Pulaski,Indiana,18131,3293,87,3380
8/21/2022,Posey,Indiana,18129,7208,59,7267
8/21/2022,Porter,Indiana,18127,43035,578,43613
8/21/2022,Sabine,Texas,48403,1413,89,1502
8/21/2022,Pike,Indiana,18125,4072,51,4123
8/21/2022,Perry,Indiana,18123,5202,70,5272
8/21/2022,Parke,Indiana,18121,3923,48,3971
8/21/2022,San Augustine,Texas,48405,1149,45,1194
8/21/2022,Owen,Indiana,18119,6438,128,6566
8/21/2022,Orange,Indiana,18117,5489,99,5588
8/21/2022,Ohio,Indiana,18115,1590,19,1609
8/21/2022,Noble,Indiana,18113,14229,162,14391
8/21/2022,Newton,Indiana,18111,2861,69,2930
8/21/2022,Morgan,Indiana,18109,18086,291,18377
8/21/2022,Montgomery,Indiana,18107,11429,167,11596
8/21/2022,Monroe,Indiana,18105,31777,292,32069
8/21/2022,San Jacinto,Texas,48407,6228,106,6334
8/21/2022,Miami,Indiana,18103,10001,165,10166
8/21/2022,Martin,Indiana,18101,2372,25,2397
8/21/2022,Marshall,Indiana,18099,13055,202,13257
8/21/2022,Marion,Indiana,18097,249040,3063,252103
8/21/2022,Madison,Indiana,18095,35950,667,36617
8/21/2022,Lawrence,Indiana,18093,13417,269,13686
8/21/2022,LaPorte,Indiana,18091,28762,376,29138
8/21/2022,Lake,Indiana,18089,120885,1882,122767
8/21/2022,LaGrange,Indiana,18087,6133,104,6237
8/21/2022,Kosciusko,Indiana,18085,21261,240,21501
8/21/2022,San Patricio,Texas,48409,12923,350,13273
8/21/2022,Knox,Indiana,18083,12170,156,12326
8/21/2022,Johnson,Indiana,18081,46830,627,47457
8/21/2022,Jennings,Indiana,18079,7517,113,7630
8/21/2022,Jefferson,Indiana,18077,9948,163,10111
8/21/2022,Jay,Indiana,18075,5303,80,5383
8/21/2022,Jasper,Indiana,18073,10073,154,10227
8/21/2022,Jackson,Indiana,18071,13741,134,13875
8/21/2022,Huntington,Indiana,18069,12884,161,13045
8/21/2022,San Saba,Texas,48411,1349,36,1385
8/21/2022,Schleicher,Texas,48413,563,9,572
8/21/2022,Howard,Indiana,18067,27838,461,28299
8/21/2022,Henry,Indiana,18065,14449,238,14687
8/21/2022,Hendricks,Indiana,18063,44449,569,45018
8/21/2022,Harrison,Indiana,18061,11990,144,12134
8/21/2022,Hancock,Indiana,18059,22841,269,23110
8/21/2022,Scurry,Texas,48415,5376,105,5481
8/21/2022,Shackelford,Texas,48417,731,12,743
8/21/2022,Shelby,Texas,48419,4796,134,4930
8/21/2022,Tucker,West Virginia,54093,2183,38,2221
8/21/2022,Hamilton,Indiana,18057,90678,688,91366
8/21/2022,Greene,Indiana,18055,8089,143,8232
8/21/2022,Clay,West Virginia,54015,2548,48,2596
8/21/2022,Clallam,Washington,53009,14339,167,14506
8/21/2022,Sherman,Texas,48421,510,16,526
8/21/2022,Grant,Indiana,18053,19024,368,19392
8/21/2022,Pepin,Wisconsin,55091,2147,18,2165
8/21/2022,Mason,Washington,53045,14323,156,14479
8/21/2022,Gibson,Indiana,18051,12902,152,13054
8/21/2022,Fulton,Indiana,18049,5282,109,5391
8/21/2022,Smith,Texas,48423,51318,982,52300
8/21/2022,Franklin,Indiana,18047,4752,67,4819
8/21/2022,Fountain,Indiana,18045,5974,107,6081
8/21/2022,Kenosha,Wisconsin,55059,50271,658,50929
8/21/2022,Okanogan,Washington,53047,9614,131,9745
8/21/2022,Somervell,Texas,48425,2164,36,2200
8/21/2022,Doddridge,West Virginia,54017,2318,18,2336
8/21/2022,Starr,Texas,48427,22200,368,22568
8/21/2022,Natrona,Wyoming,56025,24215,281,24496
8/21/2022,Pacific,Washington,53049,4358,65,4423
8/21/2022,Stephens,Texas,48429,1980,50,2030
8/21/2022,Marathon,Wisconsin,55073,44612,511,45123
8/21/2022,Brown,Wisconsin,55009,94127,579,94706
8/21/2022,Floyd,Indiana,18043,21654,310,21964
8/21/2022,Lee,Virginia,51105,6889,94,6983
8/21/2022,Fayette,Indiana,18041,7469,152,7621
8/21/2022,Sterling,Texas,48431,290,9,299
8/21/2022,Fremont,Wyoming,56013,15575,197,15772
8/21/2022,Mercer,West Virginia,54055,20137,275,20412
8/21/2022,Marinette,Wisconsin,55075,12833,133,12966
8/21/2022,Buffalo,Wisconsin,55011,3874,12,3886
8/21/2022,Mineral,West Virginia,54057,8981,161,9142
8/21/2022,Elkhart,Indiana,18039,57468,750,58218
8/21/2022,Dubois,Indiana,18037,13715,165,13880
8/21/2022,Delaware,Indiana,18035,27391,461,27852
8/21/2022,Stonewall,Texas,48433,379,7,386
8/21/2022,Mingo,West Virginia,54059,8882,126,9008
8/21/2022,DeKalb,Indiana,18033,12393,154,12547
8/21/2022,Decatur,Indiana,18031,7718,150,7868
8/21/2022,Dearborn,Indiana,18029,14760,142,14902
8/21/2022,Daviess,Indiana,18027,8123,155,8278
8/21/2022,Crawford,Indiana,18025,2789,41,2830
8/21/2022,Clinton,Indiana,18023,9973,138,10111
8/21/2022,Clay,Indiana,18021,7485,94,7579
8/21/2022,Clark,Indiana,18019,36149,406,36555
8/21/2022,Cass,Indiana,18017,12852,172,13024
8/21/2022,Carroll,Indiana,18015,4596,71,4667
8/21/2022,Brown,Indiana,18013,2835,63,2898
8/21/2022,Boone,Indiana,18011,16622,195,16817
8/21/2022,Blackford,Indiana,18009,3400,69,3469
8/21/2022,Benton,Indiana,18007,2714,23,2737
8/21/2022,Bartholomew,Indiana,18005,24092,255,24347
8/21/2022,Allen,Indiana,18003,113254,1210,114464
8/21/2022,Adams,Indiana,18001,7871,117,7988
8/21/2022,Woodford,Illinois,17203,11552,127,11679
8/21/2022,Winnebago,Illinois,17201,89249,880,90129
8/21/2022,Williamson,Illinois,17199,25722,270,25992
8/21/2022,Will,Illinois,17197,193345,1667,195012
8/21/2022,Whiteside,Illinois,17195,17673,277,17950
8/21/2022,Sutton,Texas,48435,877,14,891
8/21/2022,Swisher,Texas,48437,2452,34,2486
8/21/2022,Tarrant,Texas,48439,628104,6026,634130
8/21/2022,White,Illinois,17193,4844,61,4905
8/21/2022,Wayne,Illinois,17191,5951,86,6037
8/21/2022,Washington,Illinois,17189,3769,42,3811
8/21/2022,Warren,Illinois,17187,4556,90,4646
8/21/2022,Wabash,Illinois,17185,4229,31,4260
8/21/2022,Vermilion,Illinois,17183,31662,318,31980
8/21/2022,Taylor,Texas,48441,38941,738,39679
8/21/2022,Unknown,Illinois,,0,2577,2577
8/21/2022,Union,Illinois,17181,6096,70,6166
8/21/2022,Tazewell,Illinois,17179,41821,520,42341
8/21/2022,Stephenson,Illinois,17177,13187,187,13374
8/21/2022,St. Clair,Illinois,17163,79909,795,80704
8/21/2022,Stark,Illinois,17175,1688,39,1727
8/21/2022,Shelby,Illinois,17173,6867,81,6948
8/21/2022,Niobrara,Wyoming,56027,747,10,757
8/21/2022,Lexington city,Virginia,51678,2443,34,2477
8/21/2022,Scott,Illinois,17171,1407,13,1420
8/21/2022,Schuyler,Illinois,17169,2268,29,2297
8/21/2022,Sangamon,Illinois,17167,66935,453,67388
8/21/2022,Saline,Illinois,17165,9104,115,9219
8/21/2022,Rock Island,Illinois,17161,38400,535,38935
8/21/2022,Richland,Illinois,17159,5696,85,5781
8/21/2022,Randolph,Illinois,17157,11630,137,11767
8/21/2022,Putnam,Illinois,17155,1284,11,1295
8/21/2022,Pulaski,Illinois,17153,1894,22,1916
8/21/2022,Pope,Illinois,17151,1088,9,1097
8/21/2022,Pike,Illinois,17149,5557,71,5628
8/21/2022,Piatt,Illinois,17147,5020,29,5049
8/21/2022,Terrell,Texas,48443,131,3,134
8/21/2022,Perry,Illinois,17145,8202,106,8308
8/21/2022,Peoria,Illinois,17143,54193,555,54748
8/21/2022,Terry,Texas,48445,2861,85,2946
8/21/2022,Ogle,Illinois,17141,15731,137,15868
8/21/2022,Moultrie,Illinois,17139,4542,56,4598
8/21/2022,Morgan,Illinois,17137,10989,150,11139
8/21/2022,Montgomery,Illinois,17135,10879,113,10992
8/21/2022,Monroe,Illinois,17133,10468,132,10600
8/21/2022,Mercer,Illinois,17131,4502,51,4553
8/21/2022,Racine,Wisconsin,55101,63843,708,64551
8/21/2022,Vernon,Wisconsin,55123,6921,104,7025
8/21/2022,Throckmorton,Texas,48447,283,10,293
8/21/2022,Dodge,Wisconsin,55027,29553,344,29897
8/21/2022,Menard,Illinois,17129,4047,27,4074
8/21/2022,McLean,Illinois,17113,58704,344,59048
8/21/2022,McHenry,Illinois,17111,88408,521,88929
8/21/2022,McDonough,Illinois,17109,8200,114,8314
8/21/2022,Titus,Texas,48449,9398,129,9527
8/21/2022,Fayette,West Virginia,54019,14976,213,15189
8/21/2022,Burnett,Wisconsin,55013,4554,45,4599
8/21/2022,Tom Green,Texas,48451,46344,557,46901
8/21/2022,Gilmer,West Virginia,54021,2332,21,2353
8/21/2022,Massac,Illinois,17127,4260,74,4334
8/21/2022,Pend Oreille,Washington,53051,2733,37,2770
8/21/2022,Kewaunee,Wisconsin,55061,6314,61,6375
8/21/2022,Park,Wyoming,56029,7319,149,7468
8/21/2022,Travis,Texas,48453,267128,1772,268900
8/21/2022,Grant,West Virginia,54023,4216,58,4274
8/21/2022,Calumet,Wisconsin,55015,15747,126,15873
8/21/2022,Mason,Illinois,17125,4394,65,4459
8/21/2022,Marshall,Illinois,17123,3171,35,3206
8/21/2022,Marion,Illinois,17121,13212,219,13431
8/21/2022,Madison,Illinois,17119,79996,885,80881
8/21/2022,Loudoun,Virginia,51107,85809,408,86217
8/21/2022,Sauk,Wisconsin,55111,18522,140,18662
8/21/2022,Trinity,Texas,48455,2962,74,3036
8/21/2022,Greenbrier,West Virginia,54025,11218,166,11384
8/21/2022,Marquette,Wisconsin,55077,4292,62,4354
8/21/2022,Tyler,Texas,48457,4382,88,4470
8/21/2022,Louisa,Virginia,51109,7823,88,7911
8/21/2022,Upshur,Texas,48459,8431,189,8620
8/21/2022,Upton,Texas,48461,881,18,899
8/21/2022,Macoupin,Illinois,17117,14388,172,14560
8/21/2022,Tyler,West Virginia,54095,2432,32,2464
8/21/2022,Waushara,Wisconsin,55137,7031,87,7118
8/21/2022,Lunenburg,Virginia,51111,2901,40,2941
8/21/2022,Winnebago,Wisconsin,55139,58096,397,58493
8/21/2022,Lynchburg city,Virginia,51680,21705,285,21990
8/21/2022,Macon,Illinois,17115,35596,365,35961
8/21/2022,Logan,Illinois,17107,11169,106,11275
8/21/2022,Livingston,Illinois,17105,11962,149,12111
8/21/2022,Lee,Illinois,17103,10223,122,10345
8/21/2022,Lawrence,Illinois,17101,6011,53,6064
8/21/2022,LaSalle,Illinois,17099,33267,450,33717
8/21/2022,Lake,Illinois,17097,185262,1513,186775
8/21/2022,Knox,Illinois,17095,14424,255,14679
8/21/2022,Uvalde,Texas,48463,11195,146,11341
8/21/2022,Kendall,Illinois,17093,37409,173,37582
8/21/2022,Kankakee,Illinois,17091,32658,382,33040
8/21/2022,Kane,Illinois,17089,149040,1204,150244
8/21/2022,Johnson,Illinois,17087,5018,47,5065
8/21/2022,Val Verde,Texas,48465,15489,305,15794
8/21/2022,Jo Daviess,Illinois,17085,4584,41,4625
8/21/2022,Jersey,Illinois,17083,7004,92,7096
8/21/2022,Jefferson,Illinois,17081,12277,177,12454
8/21/2022,Jasper,Illinois,17079,2973,33,3006
8/21/2022,Jackson,Illinois,17077,17970,138,18108
8/21/2022,Iroquois,Illinois,17075,8008,123,8131
8/21/2022,Henry,Illinois,17073,14281,151,14432
8/21/2022,Henderson,Illinois,17071,1339,28,1367
8/21/2022,Van Zandt,Texas,48467,11418,290,11708
8/21/2022,Wood,Wisconsin,55141,24188,243,24431
8/21/2022,Menominee,Wisconsin,55078,2099,15,2114
8/21/2022,Uinta,Wyoming,56041,6036,40,6076
8/21/2022,Madison,Virginia,51113,2763,43,2806
8/21/2022,Pierce,Washington,53053,224773,1492,226265
8/21/2022,Victoria,Texas,48469,21183,414,21597
8/21/2022,Monongalia,West Virginia,54061,28385,200,28585
8/21/2022,Walker,Texas,48471,20800,214,21014
8/21/2022,Goshen,Wyoming,56015,4313,57,4370
8/21/2022,Clark,Washington,53011,103314,899,104213
8/21/2022,Waller,Texas,48473,10833,109,10942
8/21/2022,Ward,Texas,48475,3053,47,3100
8/21/2022,Door,Wisconsin,55029,7921,76,7997
8/21/2022,Hardin,Illinois,17069,1227,20,1247
8/21/2022,Hancock,Illinois,17067,4867,58,4925
8/21/2022,Washington,Texas,48477,10106,151,10257
8/21/2022,Hamilton,Illinois,17065,2395,35,2430
8/21/2022,Grundy,Illinois,17063,14440,145,14585
8/21/2022,Greene,Illinois,17061,3914,59,3973
8/21/2022,Gallatin,Illinois,17059,1635,21,1656
8/21/2022,Fulton,Illinois,17057,11541,140,11681
8/21/2022,Franklin,Illinois,17055,13748,185,13933
8/21/2022,Ford,Illinois,17053,4940,77,5017
8/21/2022,Fayette,Illinois,17051,7848,104,7952
8/21/2022,Effingham,Illinois,17049,11732,153,11885
8/21/2022,Webb,Texas,48479,103966,1051,105017
8/21/2022,Edwards,Illinois,17047,1962,29,1991
8/21/2022,Edgar,Illinois,17045,5846,80,5926
8/21/2022,Wharton,Texas,48481,10472,222,10694
8/21/2022,DuPage,Illinois,17043,259058,1859,260917
8/21/2022,Douglas,Illinois,17041,7220,62,7282
8/21/2022,De Witt,Illinois,17039,4837,47,4884
8/21/2022,DeKalb,Illinois,17037,28237,206,28443
8/21/2022,Cumberland,Illinois,17035,3681,49,3730
8/21/2022,Crawford,Illinois,17033,7070,62,7132
8/21/2022,Cook,Illinois,17031,1365920,15233,1381153
8/21/2022,Coles,Illinois,17029,17071,176,17247
8/21/2022,Clinton,Illinois,17027,13067,124,13191
8/21/2022,Clay,Illinois,17025,5303,75,5378
8/21/2022,Clark,Illinois,17023,5384,60,5444
8/21/2022,Christian,Illinois,17021,11604,133,11737
8/21/2022,Champaign,Illinois,17019,76056,307,76363
8/21/2022,Wheeler,Texas,48483,1259,22,1281
8/21/2022,Cass,Illinois,17017,5156,44,5200
8/21/2022,Carroll,Illinois,17015,4657,50,4707
8/21/2022,Sublette,Wyoming,56035,2150,27,2177
8/21/2022,Douglas,Wisconsin,55031,13197,81,13278
8/21/2022,San Juan,Washington,53055,1778,2,1780
8/21/2022,Wichita,Texas,48485,36137,690,36827
8/21/2022,Manassas city,Virginia,51683,10544,73,10617
8/21/2022,Skagit,Washington,53057,25953,219,26172
8/21/2022,Wilbarger,Texas,48487,3817,89,3906
8/21/2022,Dunn,Wisconsin,55033,14562,76,14638
8/21/2022,Calhoun,Illinois,17013,1716,8,1724
8/21/2022,Bureau,Illinois,17011,9268,142,9410
8/21/2022,Brown,Illinois,17009,2595,22,2617
8/21/2022,Boone,Illinois,17007,15774,132,15906
8/21/2022,Bond,Illinois,17005,4819,37,4856
8/21/2022,Alexander,Illinois,17003,1442,16,1458
8/21/2022,Adams,Illinois,17001,25181,245,25426
8/21/2022,Washington,Idaho,16087,2537,58,2595
8/21/2022,Valley,Idaho,16085,2904,16,2920
8/21/2022,Twin Falls,Idaho,16083,26509,300,26809
8/21/2022,Teton,Idaho,16081,2837,9,2846
8/21/2022,Shoshone,Idaho,16079,2967,79,3046
8/21/2022,Power,Idaho,16077,1575,21,1596
8/21/2022,Payette,Idaho,16075,6128,89,6217
8/21/2022,Owyhee,Idaho,16073,2450,53,2503
8/21/2022,Oneida,Idaho,16071,873,11,884
8/21/2022,Nez Perce,Idaho,16069,9721,154,9875
8/21/2022,Minidoka,Idaho,16067,4515,65,4580
8/21/2022,Madison,Idaho,16065,13319,54,13373
8/21/2022,Willacy,Texas,48489,8105,135,8240
8/21/2022,Lincoln,Idaho,16063,1172,15,1187
8/21/2022,Williamson,Texas,48491,155999,951,156950
8/21/2022,Lewis,Idaho,16061,1238,30,1268
8/21/2022,Lemhi,Idaho,16059,1549,28,1577
8/21/2022,Latah,Idaho,16057,7302,51,7353
8/21/2022,Kootenai,Idaho,16055,44785,624,45409
8/21/2022,Jerome,Idaho,16053,6671,65,6736
8/21/2022,Jefferson,Idaho,16051,6417,65,6482
8/21/2022,Idaho,Idaho,16049,3268,54,3322
8/21/2022,Wilson,Texas,48493,11983,161,12144
8/21/2022,Gooding,Idaho,16047,3583,57,3640
8/21/2022,Gem,Idaho,16045,3945,81,4026
8/21/2022,Fremont,Idaho,16043,2316,30,2346
8/21/2022,Winkler,Texas,48495,1989,34,2023
8/21/2022,Franklin,Idaho,16041,2486,30,2516
8/21/2022,Wise,Texas,48497,18209,275,18484
8/21/2022,Elmore,Idaho,16039,8168,70,8238
8/21/2022,Custer,Idaho,16037,650,9,659
8/21/2022,Clearwater,Idaho,16035,2468,34,2502
8/21/2022,Clark,Idaho,16033,115,1,116
8/21/2022,Cassia,Idaho,16031,5264,55,5319
8/21/2022,Caribou,Idaho,16029,1585,34,1619
8/21/2022,Canyon,Idaho,16027,66131,700,66831
8/21/2022,Camas,Idaho,16025,167,2,169
8/21/2022,Butte,Idaho,16023,512,11,523
8/21/2022,Wood,Texas,48499,8829,292,9121
8/21/2022,Skamania,Washington,53059,1695,15,1710
8/21/2022,Boundary,Idaho,16021,2253,64,2317
8/21/2022,Bonneville,Idaho,16019,33214,291,33505
8/21/2022,Bonner,Idaho,16017,9659,191,9850
8/21/2022,Boise,Idaho,16015,1211,14,1225
8/21/2022,Blaine,Idaho,16013,6706,31,6737
8/21/2022,Bingham,Idaho,16011,10499,163,10662
8/21/2022,Benewah,Idaho,16009,2613,41,2654
8/21/2022,Bear Lake,Idaho,16007,1036,16,1052
8/21/2022,Bannock,Idaho,16005,22766,258,23024
8/21/2022,Adams,Idaho,16003,758,15,773
8/21/2022,Ada,Idaho,16001,149367,1053,150420
8/21/2022,Unknown,Hawaii,,0,9,9
8/21/2022,Maui,Hawaii,15009,40192,152,40344
8/21/2022,Kauai,Hawaii,15007,16865,39,16904
8/21/2022,Kalawao,Hawaii,15005,1,0,1
8/21/2022,Honolulu,Hawaii,15003,232683,1205,233888
8/21/2022,Hawaii,Hawaii,15001,37434,211,37645
8/21/2022,Unknown,Guam,,58175,390,58565
8/21/2022,Yoakum,Texas,48501,1525,42,1567
8/21/2022,Worth,Georgia,13321,5186,121,5307
8/21/2022,Wilkinson,Georgia,13319,2500,61,2561
8/21/2022,Wilkes,Georgia,13317,2428,56,2484
8/21/2022,Wilcox,Georgia,13315,2224,71,2295
8/21/2022,Whitfield,Georgia,13313,36764,452,37216
8/21/2022,White,Georgia,13311,7596,168,7764
8/21/2022,Wheeler,Georgia,13309,1494,39,1533
8/21/2022,Webster,Georgia,13307,498,9,507
8/21/2022,Wayne,Georgia,13305,8362,208,8570
8/21/2022,Washington,Georgia,13303,4825,139,4964
8/21/2022,Warren,Georgia,13301,1188,30,1218
8/21/2022,Ware,Georgia,13299,10899,291,11190
8/21/2022,Young,Texas,48503,4290,95,4385
8/21/2022,Walton,Georgia,13297,24318,445,24763
8/21/2022,Walker,Georgia,13295,18730,256,18986
8/21/2022,Zapata,Texas,48505,4072,55,4127
8/21/2022,Upson,Georgia,13293,8726,245,8971
8/21/2022,Unknown,Georgia,,12561,4,12565
8/21/2022,Union,Georgia,13291,5588,166,5754
8/21/2022,Twiggs,Georgia,13289,1714,70,1784
8/21/2022,Turner,Georgia,13287,2915,63,2978
8/21/2022,Troup,Georgia,13285,17335,392,17727
8/21/2022,Zavala,Texas,48507,4336,69,4405
8/21/2022,Treutlen,Georgia,13283,1751,65,1816
8/21/2022,Towns,Georgia,13281,2654,118,2772
8/21/2022,Toombs,Georgia,13279,7604,206,7810
8/21/2022,Tift,Georgia,13277,12870,230,13100
8/21/2022,Thomas,Georgia,13275,13315,218,13533
8/21/2022,Terrell,Georgia,13273,2327,68,2395
8/21/2022,Telfair,Georgia,13271,3278,87,3365
8/21/2022,Taylor,Georgia,13269,2209,54,2263
8/21/2022,Tattnall,Georgia,13267,5485,135,5620
8/21/2022,Taliaferro,Georgia,13265,307,4,311
8/21/2022,Talbot,Georgia,13263,1265,33,1298
8/21/2022,Sumter,Georgia,13261,7894,174,8068
8/21/2022,Stewart,Georgia,13259,2883,35,2918
8/21/2022,Stephens,Georgia,13257,6802,168,6970
8/21/2022,Spalding,Georgia,13255,17811,428,18239
8/21/2022,Seminole,Georgia,13253,2345,32,2377
8/21/2022,Screven,Georgia,13251,2950,71,3021
8/21/2022,Schley,Georgia,13249,1307,11,1318
8/21/2022,Rockdale,Georgia,13247,21545,332,21877
8/21/2022,Richmond,Georgia,13245,55960,912,56872
8/21/2022,Randolph,Georgia,13243,1659,48,1707
8/21/2022,Rabun,Georgia,13241,3921,102,4023
8/21/2022,Quitman,Georgia,13239,485,5,490
8/21/2022,Putnam,Georgia,13237,4922,109,5031
8/21/2022,Hampshire,West Virginia,54027,6600,74,6674
8/21/2022,Chippewa,Wisconsin,55017,20388,196,20584
8/21/2022,Clark,Wisconsin,55019,8320,125,8445
8/21/2022,Beaver,Utah,49001,1704,16,1720
8/21/2022,Box Elder,Utah,49003,15141,127,15268
8/21/2022,Shenandoah,Virginia,51171,12132,239,12371
8/21/2022,Cache,Utah,49005,39654,113,39767
8/21/2022,Pulaski,Georgia,13235,2445,80,2525
8/21/2022,Polk,Georgia,13233,13007,201,13208
8/21/2022,Pike,Georgia,13231,5988,101,6089
8/21/2022,Pierce,Georgia,13229,6108,137,6245
8/21/2022,Carbon,Utah,49007,5692,49,5741
8/21/2022,Pickens,Georgia,13227,9266,174,9440
8/21/2022,Peach,Georgia,13225,7280,136,7416
8/21/2022,Paulding,Georgia,13223,42926,445,43371
8/21/2022,Daggett,Utah,49009,163,0,163
8/21/2022,Oglethorpe,Georgia,13221,3501,59,3560
8/21/2022,Oconee,Georgia,13219,9521,109,9630
8/21/2022,Newton,Georgia,13217,27797,470,28267
8/21/2022,Muscogee,Georgia,13215,42361,855,43216
8/21/2022,Murray,Georgia,13213,12600,196,12796
8/21/2022,Smyth,Virginia,51173,10243,177,10420
8/21/2022,Morgan,Georgia,13211,5070,70,5140
8/21/2022,Montgomery,Georgia,13209,2190,54,2244
8/21/2022,Monroe,Georgia,13207,6564,178,6742
8/21/2022,Mitchell,Georgia,13205,5922,121,6043
8/21/2022,Miller,Georgia,13201,1897,31,1928
8/21/2022,Meriwether,Georgia,13199,5033,148,5181
8/21/2022,McIntosh,Georgia,13191,2711,38,2749
8/21/2022,McDuffie,Georgia,13189,5671,106,5777
8/21/2022,Marion,Georgia,13197,1721,52,1773
8/21/2022,Madison,Georgia,13195,7488,114,7602
8/21/2022,Macon,Georgia,13193,2464,52,2516
8/21/2022,Lumpkin,Georgia,13187,8119,135,8254
8/21/2022,Lowndes,Georgia,13185,34557,405,34962
8/21/2022,Long,Georgia,13183,3174,35,3209
8/21/2022,Lincoln,Georgia,13181,1728,35,1763
8/21/2022,Liberty,Georgia,13179,14262,154,14416
8/21/2022,Davis,Utah,49011,111472,420,111892
8/21/2022,Lee,Georgia,13177,8165,107,8272
8/21/2022,Laurens,Georgia,13175,15113,312,15425
8/21/2022,Lanier,Georgia,13173,2536,27,2563
8/21/2022,Lamar,Georgia,13171,5397,121,5518
8/21/2022,Jones,Georgia,13169,5629,111,5740
8/21/2022,Duchesne,Utah,49013,4780,27,4807
8/21/2022,Johnson,Georgia,13167,2436,76,2512
8/21/2022,Jenkins,Georgia,13165,1653,68,1721
8/21/2022,Eau Claire,Wisconsin,55035,33869,195,34064
8/21/2022,Upshur,West Virginia,54097,7912,99,8011
8/21/2022,Manassas Park city,Virginia,51685,4348,28,4376
8/21/2022,Emery,Utah,49015,2737,28,2765
8/21/2022,Florence,Wisconsin,55037,1201,17,1218
8/21/2022,Monroe,West Virginia,54063,4941,48,4989
8/21/2022,Southampton,Virginia,51175,4016,96,4112
8/21/2022,Martinsville city,Virginia,51690,3866,124,3990
8/21/2022,Spotsylvania,Virginia,51177,31703,308,32011
8/21/2022,Jefferson,Georgia,13163,3977,114,4091
8/21/2022,Wayne,West Virginia,54099,10836,131,10967
8/21/2022,Washburn,Wisconsin,55129,4558,47,4605
8/21/2022,Jeff Davis,Georgia,13161,4196,74,4270
8/21/2022,Jasper,Georgia,13159,3468,75,3543
8/21/2022,Jackson,Georgia,13157,23020,295,23315
8/21/2022,Irwin,Georgia,13155,2091,51,2142
8/21/2022,Houston,Georgia,13153,45795,518,46313
8/21/2022,Garfield,Utah,49017,1001,16,1017
8/21/2022,Henry,Georgia,13151,65743,707,66450
8/21/2022,Heard,Georgia,13149,2383,58,2441
8/21/2022,Grand,Utah,49019,2616,6,2622
8/21/2022,Hart,Georgia,13147,5213,106,5319
8/21/2022,Harris,Georgia,13145,6647,118,6765
8/21/2022,Haralson,Georgia,13143,5937,178,6115
8/21/2022,Hancock,Georgia,13141,1809,90,1899
8/21/2022,Hall,Georgia,13139,59698,868,60566
8/21/2022,Habersham,Georgia,13137,10939,271,11210
8/21/2022,Gwinnett,Georgia,13135,235973,1951,237924
8/21/2022,Greene,Georgia,13133,4362,89,4451
8/21/2022,Grady,Georgia,13131,6501,113,6614
8/21/2022,Gordon,Georgia,13129,18503,274,18777
8/21/2022,Glynn,Georgia,13127,25725,415,26140
8/21/2022,Glascock,Georgia,13125,650,26,676
8/21/2022,Gilmer,Georgia,13123,7671,182,7853
8/21/2022,Fulton,Georgia,13121,254568,2461,257029
8/21/2022,Franklin,Georgia,13119,5763,105,5868
8/21/2022,Forsyth,Georgia,13117,62948,420,63368
8/21/2022,Floyd,Georgia,13115,29951,536,30487
8/21/2022,Fayette,Georgia,13113,26598,343,26941
8/21/2022,Fannin,Georgia,13111,5543,170,5713
8/21/2022,Evans,Georgia,13109,2681,64,2745
8/21/2022,Emanuel,Georgia,13107,6403,164,6567
8/21/2022,Elbert,Georgia,13105,4857,114,4971
8/21/2022,Effingham,Georgia,13103,15165,201,15366
8/21/2022,Echols,Georgia,13101,1007,12,1019
8/21/2022,Early,Georgia,13099,3032,65,3097
8/21/2022,Douglas,Georgia,13097,39665,423,40088
8/21/2022,Dougherty,Georgia,13095,22325,517,22842
8/21/2022,Dooly,Georgia,13093,2667,70,2737
8/21/2022,Iron,Utah,49021,15699,95,15794
8/21/2022,Dodge,Georgia,13091,5613,160,5773
8/21/2022,DeKalb,Georgia,13089,176552,1809,178361
8/21/2022,Juab,Utah,49023,3072,26,3098
8/21/2022,Decatur,Georgia,13087,8041,134,8175
8/21/2022,Dawson,Georgia,13085,7776,103,7879
8/21/2022,Dade,Georgia,13083,3724,35,3759
8/21/2022,Crisp,Georgia,13081,5302,138,5440
8/21/2022,Crawford,Georgia,13079,2021,59,2080
8/21/2022,Coweta,Georgia,13077,37588,504,38092
8/21/2022,Kane,Utah,49025,1488,15,1503
8/21/2022,Cook,Georgia,13075,5387,77,5464
8/21/2022,Columbia,Georgia,13073,39851,400,40251
8/21/2022,Colquitt,Georgia,13071,12892,256,13148
8/21/2022,Coffee,Georgia,13069,11434,290,11724
8/21/2022,Cobb,Georgia,13067,200138,1920,202058
8/21/2022,Millard,Utah,49027,3491,36,3527
8/21/2022,Clinch,Georgia,13065,2335,43,2378
8/21/2022,Clayton,Georgia,13063,72135,1022,73157
8/21/2022,Clay,Georgia,13061,576,6,582
8/21/2022,Clarke,Georgia,13059,32675,247,32922
8/21/2022,Cherokee,Georgia,13057,70679,658,71337
8/21/2022,Chattooga,Georgia,13055,7259,138,7397
8/21/2022,Morgan,Utah,49029,3084,15,3099
8/21/2022,Stafford,Virginia,51179,36830,182,37012
8/21/2022,Piute,Utah,49031,324,7,331
8/21/2022,Hancock,West Virginia,54029,7559,143,7702
8/21/2022,Mathews,Virginia,51115,1711,27,1738
8/21/2022,Mecklenburg,Virginia,51117,6952,133,7085
8/21/2022,Rich,Utah,49033,361,0,361
8/21/2022,Snohomish,Washington,53061,186701,1255,187956
8/21/2022,Platte,Wyoming,56031,2114,42,2156
8/21/2022,Spokane,Washington,53063,140955,1489,142444
8/21/2022,Middlesex,Virginia,51119,2148,48,2196
8/21/2022,Salt Lake,Utah,49035,384005,1705,385710
8/21/2022,San Juan,Utah,49037,4492,50,4542
8/21/2022,Columbia,Washington,53013,672,16,688
8/21/2022,Sanpete,Utah,49039,8676,56,8732
8/21/2022,Morgan,West Virginia,54065,4654,71,4725
8/21/2022,Chattahoochee,Georgia,13053,7647,22,7669
8/21/2022,Chatham,Georgia,13051,73349,932,74281
8/21/2022,Nicholas,West Virginia,54067,8478,100,8578
8/21/2022,Cowlitz,Washington,53015,25590,373,25963
8/21/2022,Charlton,Georgia,13049,3271,64,3335
8/21/2022,Sevier,Utah,49041,5700,30,5730
8/21/2022,Catoosa,Georgia,13047,16079,184,16263
8/21/2022,Carroll,Georgia,13045,26185,471,26656
8/21/2022,Candler,Georgia,13043,2422,104,2526
8/21/2022,Camden,Georgia,13039,12850,126,12976
8/21/2022,Calhoun,Georgia,13037,1482,24,1506
8/21/2022,Butts,Georgia,13035,7157,166,7323
8/21/2022,Summit,Utah,49043,15089,27,15116
8/21/2022,Burke,Georgia,13033,5872,114,5986
8/21/2022,Bulloch,Georgia,13031,16973,270,17243
8/21/2022,Bryan,Georgia,13029,10275,98,10373
8/21/2022,Brooks,Georgia,13027,3784,89,3873
8/21/2022,Brantley,Georgia,13025,4484,113,4597
8/21/2022,Bleckley,Georgia,13023,3645,101,3746
8/21/2022,Bibb,Georgia,13021,42155,808,42963
8/21/2022,Milwaukee,Wisconsin,55079,308249,2351,310600
8/21/2022,Lincoln,Wyoming,56023,4594,32,4626
8/21/2022,Tooele,Utah,49045,23520,108,23628
8/21/2022,Montgomery,Virginia,51121,21898,160,22058
8/21/2022,Hardy,West Virginia,54031,4895,50,4945
8/21/2022,Uintah,Utah,49047,8955,76,9031
8/21/2022,Berrien,Georgia,13019,5422,86,5508
8/21/2022,Ben Hill,Georgia,13017,4706,123,4829
8/21/2022,Bartow,Georgia,13015,32352,457,32809
8/21/2022,Barrow,Georgia,13013,24070,266,24336
8/21/2022,Banks,Georgia,13011,4305,98,4403
8/21/2022,Baldwin,Georgia,13009,10551,246,10797
8/21/2022,Baker,Georgia,13007,596,15,611
8/21/2022,Bacon,Georgia,13005,3961,79,4040
8/21/2022,Atkinson,Georgia,13003,2365,53,2418
8/21/2022,Appling,Georgia,13001,5085,133,5218
8/21/2022,Unknown,Utah,,4631,102,4733
8/21/2022,Washington,Florida,12133,7201,115,7316
8/21/2022,Walton,Florida,12131,18340,220,18560
8/21/2022,Utah,Utah,49049,216754,829,217583
8/21/2022,Wakulla,Florida,12129,11191,132,11323
8/21/2022,Volusia,Florida,12127,137683,2112,139795
8/21/2022,Unknown,Florida,,45420,458,45878
8/21/2022,Union,Florida,12125,4717,120,4837
8/21/2022,Taylor,Florida,12123,7601,106,7707
8/21/2022,Suwannee,Florida,12121,14399,328,14727
8/21/2022,Sumter,Florida,12119,26546,622,27168
8/21/2022,Wasatch,Utah,49051,11594,37,11631
8/21/2022,St. Lucie,Florida,12111,87447,1295,88742
8/21/2022,St. Johns,Florida,12109,72055,611,72666
8/21/2022,Seminole,Florida,12117,121778,1160,122938
8/21/2022,Sarasota,Florida,12115,109131,1762,110893
8/21/2022,Santa Rosa,Florida,12113,54833,649,55482
8/21/2022,Putnam,Florida,12107,19696,435,20131
8/21/2022,Polk,Florida,12105,236566,3157,239723
8/21/2022,Washington,Utah,49053,48333,480,48813
8/21/2022,Pinellas,Florida,12103,250838,3613,254451
8/21/2022,Pasco,Florida,12101,145644,2042,147686
8/21/2022,Palm Beach,Florida,12099,436232,5414,441646
8/21/2022,Osceola,Florida,12097,132958,1190,134148
8/21/2022,Orange,Florida,12095,441074,3004,444078
8/21/2022,Okeechobee,Florida,12093,11647,187,11834
8/21/2022,Okaloosa,Florida,12091,57608,713,58321
8/21/2022,Nassau,Florida,12089,25107,315,25422
8/21/2022,Monroe,Florida,12087,20990,127,21117
8/21/2022,Miami-Dade,Florida,12086,1416473,11500,1427973
8/21/2022,Martin,Florida,12085,36140,663,36803
8/21/2022,Wayne,Utah,49055,487,0,487
8/21/2022,Marion,Florida,12083,95854,2248,98102
8/21/2022,Weber,Utah,49057,79225,457,79682
8/21/2022,Manatee,Florida,12081,112701,1545,114246
8/21/2022,Addison,Vermont,50001,6419,22,6441
8/21/2022,Bennington,Vermont,50003,11132,73,11205
8/21/2022,Madison,Florida,12079,6562,98,6660
8/21/2022,Liberty,Florida,12077,2770,30,2800
8/21/2022,Levy,Florida,12075,11669,175,11844
8/21/2022,Leon,Florida,12073,102596,707,103303
8/21/2022,Lee,Florida,12071,220287,2285,222572
8/21/2022,Lake,Florida,12069,99481,1606,101087
8/21/2022,Lafayette,Florida,12067,2978,61,3039
8/21/2022,Jefferson,Florida,12065,4581,62,4643
8/21/2022,Jackson,Florida,12063,16520,289,16809
8/21/2022,Indian River,Florida,12061,38940,703,39643
8/21/2022,Nelson,Virginia,51125,2953,37,2990
8/21/2022,Caledonia,Vermont,50005,6235,31,6266
8/21/2022,Holmes,Florida,12059,5940,95,6035
8/21/2022,Hillsborough,Florida,12057,441085,4034,445119
8/21/2022,Highlands,Florida,12055,28018,728,28746
8/21/2022,Hernando,Florida,12053,49367,1178,50545
8/21/2022,Hendry,Florida,12051,12919,161,13080
8/21/2022,Hardee,Florida,12049,9570,127,9697
8/21/2022,Hamilton,Florida,12047,4242,56,4298
8/21/2022,Gulf,Florida,12045,4711,82,4793
8/21/2022,Glades,Florida,12043,2171,36,2207
8/21/2022,Gilchrist,Florida,12041,5202,105,5307
8/21/2022,Gadsden,Florida,12039,15890,217,16107
8/21/2022,Franklin,Florida,12037,3330,55,3385
8/21/2022,Flagler,Florida,12035,26315,386,26701
8/21/2022,Escambia,Florida,12033,87934,1381,89315
8/21/2022,Duval,Florida,12031,291875,3563,295438
8/21/2022,Dixie,Florida,12029,4565,75,4640
8/21/2022,DeSoto,Florida,12027,10505,157,10662
8/21/2022,Columbia,Florida,12023,23511,422,23933
8/21/2022,Collier,Florida,12021,95854,1062,96916
8/21/2022,Clay,Florida,12019,61504,896,62400
8/21/2022,Citrus,Florida,12017,35304,1033,36337
8/21/2022,Chittenden,Vermont,50007,37090,185,37275
8/21/2022,Charlotte,Florida,12015,43369,870,44239
8/21/2022,Calhoun,Florida,12013,4540,101,4641
8/21/2022,Broward,Florida,12011,712804,6199,719003
8/21/2022,Brevard,Florida,12009,159779,2274,162053
8/21/2022,Bradford,Florida,12007,8439,161,8600
8/21/2022,Essex,Vermont,50009,1370,3,1373
8/21/2022,La Crosse,Wisconsin,55063,39854,196,40050
8/21/2022,Douglas,Washington,53017,12509,77,12586
8/21/2022,New Kent,Virginia,51127,5367,38,5405
8/21/2022,Bay,Florida,12005,51250,844,52094
8/21/2022,Baker,Florida,12003,9606,144,9750
8/21/2022,Alachua,Florida,12001,80981,716,81697
8/21/2022,District of Columbia,District of Columbia,11001,165055,1377,166432
8/21/2022,Unknown,Delaware,,1058,0,1058
8/21/2022,Franklin,Vermont,50011,10788,69,10857
8/21/2022,Sussex,Delaware,10005,70239,887,71126
8/21/2022,New Castle,Delaware,10003,170666,1478,172144
8/21/2022,Lafayette,Wisconsin,55065,4052,29,4081
8/21/2022,Grand Isle,Vermont,50013,1206,6,1212
8/21/2022,Webster,West Virginia,54101,2608,35,2643
8/21/2022,Lamoille,Vermont,50015,4129,19,4148
8/21/2022,Sweetwater,Wyoming,56037,11982,129,12111
8/21/2022,Orange,Vermont,50017,4736,14,4750
8/21/2022,Staunton city,Virginia,51790,6799,121,6920
8/21/2022,Harrison,West Virginia,54033,23203,264,23467
8/21/2022,Richland,Wisconsin,55103,4483,51,4534
8/21/2022,Orleans,Vermont,50019,6932,38,6970
8/21/2022,Ferry,Washington,53019,1624,30,1654
8/21/2022,Rutland,Vermont,50021,15024,80,15104
8/21/2022,Franklin,Washington,53021,35258,217,35475
8/21/2022,Stevens,Washington,53065,9128,156,9284
8/21/2022,Unknown,Vermont,,2281,4,2285
8/21/2022,Kent,Delaware,10001,58282,674,58956
8/21/2022,Windham,Connecticut,9015,28794,312,29106
8/21/2022,Unknown,Connecticut,,2782,1,2783
8/21/2022,Tolland,Connecticut,9013,24728,290,25018
8/21/2022,New London,Connecticut,9011,65302,699,66001
8/21/2022,Ohio,West Virginia,54069,12712,187,12899
8/21/2022,Fond du Lac,Wisconsin,55039,35334,290,35624
8/21/2022,Suffolk city,Virginia,51800,21889,314,22203
8/21/2022,Garfield,Washington,53023,441,7,448
8/21/2022,Monroe,Wisconsin,55081,13422,101,13523
8/21/2022,Pierce,Wisconsin,55093,12599,75,12674
8/21/2022,Sheboygan,Wisconsin,55117,36233,339,36572
8/21/2022,Pendleton,West Virginia,54071,2133,22,2155
8/21/2022,Newport News city,Virginia,51700,43329,421,43750
8/21/2022,Wetzel,West Virginia,54103,4905,89,4994
8/21/2022,Washington,Vermont,50023,13317,57,13374
8/21/2022,Grant,Washington,53025,30261,264,30525
8/21/2022,Norfolk city,Virginia,51710,48641,494,49135
8/21/2022,New Haven,Connecticut,9009,228399,2902,231301
8/21/2022,Surry,Virginia,51181,1237,20,1257
8/21/2022,Middlesex,Connecticut,9007,34390,491,34881
8/21/2022,Litchfield,Connecticut,9005,36892,474,37366
8/21/2022,Hartford,Connecticut,9003,209448,3232,212680
8/21/2022,Fairfield,Connecticut,9001,237459,2779,240238
8/21/2022,Windham,Vermont,50025,7855,40,7895
8/21/2022,Polk,Wisconsin,55095,13719,123,13842
8/21/2022,Yuma,Colorado,8125,2143,26,2169
8/21/2022,Windsor,Vermont,50027,10712,61,10773
8/21/2022,Weld,Colorado,8123,97840,720,98560
8/21/2022,Washington,Colorado,8121,1126,29,1155
8/21/2022,Teller,Colorado,8119,5515,59,5574
8/21/2022,Accomack,Virginia,51001,7968,111,8079
8/21/2022,Summit,Colorado,8117,11390,14,11404
8/21/2022,Sedgwick,Colorado,8115,517,10,527
8/21/2022,San Miguel,Colorado,8113,2572,8,2580
8/21/2022,San Juan,Colorado,8111,294,0,294
8/21/2022,Saguache,Colorado,8109,1384,12,1396
8/21/2022,Routt,Colorado,8107,7374,30,7404
8/21/2022,Rio Grande,Colorado,8105,3263,46,3309
8/21/2022,Rio Blanco,Colorado,8103,1978,13,1991
8/21/2022,Pueblo,Colorado,8101,55195,834,56029
8/21/2022,Prowers,Colorado,8099,2833,51,2884
8/21/2022,Pitkin,Colorado,8097,7670,8,7678
8/21/2022,Phillips,Colorado,8095,974,20,994
8/21/2022,Park,Colorado,8093,3261,22,3283
8/21/2022,Ouray,Colorado,8091,1037,6,1043
8/21/2022,Otero,Colorado,8089,4825,132,4957
8/21/2022,Morgan,Colorado,8087,6379,138,6517
8/21/2022,Montrose,Colorado,8085,10390,170,10560
8/21/2022,Montezuma,Colorado,8083,6840,83,6923
8/21/2022,Moffat,Colorado,8081,3363,53,3416
8/21/2022,Mineral,Colorado,8079,283,3,286
8/21/2022,Albemarle,Virginia,51003,22056,179,22235
8/21/2022,Alexandria city,Virginia,51510,40288,198,40486
8/21/2022,Mesa,Colorado,8077,47362,597,47959
8/21/2022,Logan,Colorado,8075,8057,113,8170
8/21/2022,Lincoln,Colorado,8073,2323,10,2333
8/21/2022,Las Animas,Colorado,8071,3923,45,3968
8/21/2022,Larimer,Colorado,8069,97651,542,98193
8/21/2022,La Plata,Colorado,8067,14552,90,14642
8/21/2022,Lake,Colorado,8065,2086,2,2088
8/21/2022,Kit Carson,Colorado,8063,1760,33,1793
8/21/2022,Kiowa,Colorado,8061,355,6,361
8/21/2022,Jefferson,Colorado,8059,148387,1429,149816
8/21/2022,Jackson,Colorado,8057,192,0,192
8/21/2022,Alleghany,Virginia,51005,3856,103,3959
8/21/2022,Huerfano,Colorado,8055,1645,38,1683
8/21/2022,Hinsdale,Colorado,8053,153,0,153
8/21/2022,Gunnison,Colorado,8051,3727,14,3741
8/21/2022,Grand,Colorado,8049,3837,28,3865
8/21/2022,Gilpin,Colorado,8047,1109,5,1114
8/21/2022,Amelia,Virginia,51007,3070,58,3128
8/21/2022,Garfield,Colorado,8045,16872,97,16969
8/21/2022,Amherst,Virginia,51009,8320,97,8417
8/21/2022,Fremont,Colorado,8043,17104,193,17297
8/21/2022,El Paso,Colorado,8041,217159,1776,218935
8/21/2022,Elbert,Colorado,8039,5447,44,5491
8/21/2022,Eagle,Colorado,8037,17880,37,17917
8/21/2022,St. Croix,Wisconsin,55109,28064,155,28219
8/21/2022,Appomattox,Virginia,51011,4392,56,4448
8/21/2022,Langlade,Wisconsin,55067,5920,94,6014
8/21/2022,Sheridan,Wyoming,56033,9073,81,9154
8/21/2022,Douglas,Colorado,8035,94900,494,95394
8/21/2022,Dolores,Colorado,8033,384,8,392
8/21/2022,Denver,Colorado,8031,207110,1422,208532
8/21/2022,Delta,Colorado,8029,6713,144,6857
8/21/2022,Custer,Colorado,8027,763,22,785
8/21/2022,Crowley,Colorado,8025,3455,31,3486
8/21/2022,Costilla,Colorado,8023,850,19,869
8/21/2022,Conejos,Colorado,8021,2085,57,2142
8/21/2022,Clear Creek,Colorado,8019,1820,12,1832
8/21/2022,Cheyenne,Colorado,8017,349,9,358
8/21/2022,Chaffee,Colorado,8015,5308,52,5360
8/21/2022,Broomfield,Colorado,8014,16752,122,16874
8/21/2022,Boulder,Colorado,8013,82647,394,83041
8/21/2022,Bent,Colorado,8011,2706,47,2753
8/21/2022,Baca,Colorado,8009,941,14,955
8/21/2022,Archuleta,Colorado,8007,3219,17,3236
8/21/2022,Arapahoe,Colorado,8005,184948,1353,186301
8/21/2022,Alamosa,Colorado,8003,5254,62,5316
8/21/2022,Adams,Colorado,8001,157053,1439,158492
8/21/2022,Wirt,West Virginia,54105,1614,25,1639
8/21/2022,Yuba,California,6115,19983,129,20112
8/21/2022,Yolo,California,6113,50735,333,51068
8/21/2022,Ventura,California,6111,217614,1547,219161
8/21/2022,Forest,Wisconsin,55041,3034,52,3086
8/21/2022,Sussex,Virginia,51183,2720,44,2764
8/21/2022,Hot Springs,Wyoming,56017,1326,18,1344
8/21/2022,Johnson,Wyoming,56019,2123,20,2143
8/21/2022,Tuolumne,California,6109,16322,196,16518
8/21/2022,Thurston,Washington,53067,57700,459,58159
8/21/2022,Arlington,Virginia,51013,58762,332,59094
8/21/2022,Augusta,Virginia,51015,22031,224,22255
8/21/2022,Campbell,Wyoming,56005,13123,150,13273
8/21/2022,Oconto,Wisconsin,55083,12327,125,12452
8/21/2022,Bath,Virginia,51017,1014,22,1036
8/21/2022,Washington,Wisconsin,55131,42750,348,43098
8/21/2022,Bedford,Virginia,51019,19393,251,19644
8/21/2022,Northampton,Virginia,51131,2585,69,2654
8/21/2022,Pleasants,West Virginia,54073,2279,38,2317
8/21/2022,Bland,Virginia,51021,2068,24,2092
8/21/2022,Pocahontas,West Virginia,54075,2277,32,2309
8/21/2022,Preston,West Virginia,54077,10098,140,10238
8/21/2022,Northumberland,Virginia,51133,2429,43,2472
8/21/2022,Tulare,California,6107,153261,1521,154782
8/21/2022,Jackson,West Virginia,54035,7859,141,8000
8/21/2022,Botetourt,Virginia,51023,8598,106,8704
8/21/2022,Bristol city,Virginia,51520,5125,84,5209
8/21/2022,Trinity,California,6105,1722,20,1742
8/21/2022,Tehama,California,6103,16261,209,16470
8/21/2022,Putnam,West Virginia,54079,19068,196,19264
8/21/2022,Norton city,Virginia,51720,1550,22,1572
8/21/2022,Sutter,California,6101,25983,235,26218
8/21/2022,Stanislaus,California,6099,154601,1719,156320
8/21/2022,Sonoma,California,6097,109021,511,109532
8/21/2022,Solano,California,6095,109743,457,110200
8/21/2022,Siskiyou,California,6093,8351,107,8458
8/21/2022,Brunswick,Virginia,51025,3632,49,3681
8/21/2022,Sierra,California,6091,357,4,361
8/21/2022,Shasta,California,6089,41197,673,41870
8/21/2022,Santa Cruz,California,6087,64335,269,64604
8/21/2022,Jefferson,West Virginia,54037,16312,137,16449
8/21/2022,Raleigh,West Virginia,54081,26878,372,27250
8/21/2022,Portage,Wisconsin,55097,20560,164,20724
8/21/2022,Tazewell,Virginia,51185,11730,187,11917
8/21/2022,Virginia Beach city,Virginia,51810,104109,880,104989
8/21/2022,Santa Clara,California,6085,437874,2437,440311
8/21/2022,Santa Barbara,California,6083,109217,713,109930
8/21/2022,San Mateo,California,6081,173884,808,174692
8/21/2022,Grays Harbor,Washington,53027,18937,214,19151
8/21/2022,Washakie,Wyoming,56043,2597,47,2644
8/21/2022,Nottoway,Virginia,51135,4933,96,5029
8/21/2022,San Luis Obispo,California,6079,68521,516,69037
8/21/2022,San Joaquin,California,6077,206181,2288,208469
8/21/2022,San Francisco,California,6075,185807,973,186780
8/21/2022,San Diego,California,6073,973147,5448,978595
8/21/2022,San Bernardino,California,6071,677603,8014,685617
8/21/2022,San Benito,California,6069,16568,103,16671
8/21/2022,Sacramento,California,6067,370036,3379,373415
8/21/2022,Riverside,California,6065,712991,6635,719626
8/21/2022,Buchanan,Virginia,51027,5269,129,5398
8/21/2022,Plumas,California,6063,3977,13,3990
8/21/2022,Placer,California,6061,83119,657,83776
8/21/2022,Orange,California,6059,711000,7303,718303
8/21/2022,Nevada,California,6057,20175,132,20307
8/21/2022,Napa,California,6055,32904,156,33060
8/21/2022,Monterey,California,6053,112148,777,112925
8/21/2022,Mono,California,6051,3410,7,3417
8/21/2022,Modoc,California,6049,1177,11,1188
8/21/2022,Merced,California,6047,81219,846,82065
8/21/2022,Mendocino,California,6045,19770,134,19904
8/21/2022,Mariposa,California,6043,3984,37,4021
8/21/2022,Marin,California,6041,49032,305,49337
8/21/2022,Madera,California,6039,50451,372,50823
8/21/2022,Los Angeles,California,6037,3376611,33003,3409614
8/21/2022,Lassen,California,6035,11322,69,11391
8/21/2022,Lake,California,6033,13520,142,13662
8/21/2022,Kings,California,6031,62050,454,62504
8/21/2022,Kern,California,6029,276430,2508,278938
8/21/2022,Inyo,California,6027,5285,59,5344
8/21/2022,Imperial,California,6025,78917,951,79868
8/21/2022,Humboldt,California,6023,25704,154,25858
8/21/2022,Glenn,California,6021,7228,48,7276
8/21/2022,Fresno,California,6019,296749,2822,299571
8/21/2022,Buckingham,Virginia,51029,4516,60,4576
8/21/2022,El Dorado,California,6017,35681,225,35906
8/21/2022,Del Norte,California,6015,7671,55,7726
8/21/2022,Contra Costa,California,6013,260905,1399,262304
8/21/2022,Colusa,California,6011,4932,22,4954
8/21/2022,Calaveras,California,6009,8809,132,8941
8/21/2022,Butte,California,6007,46758,449,47207
8/21/2022,Orange,Virginia,51137,7957,94,8051
8/21/2022,Kanawha,West Virginia,54039,53925,771,54696
8/21/2022,Amador,California,6005,10627,89,10716
8/21/2022,Alpine,California,6003,132,0,132
8/21/2022,Alameda,California,6001,356614,1972,358586
8/21/2022,Yell,Arkansas,5149,7210,108,7318
8/21/2022,Buena Vista city,Virginia,51530,2041,45,2086
8/21/2022,Woodruff,Arkansas,5147,2018,31,2049
8/21/2022,White,Arkansas,5145,24479,311,24790
8/21/2022,Washington,Arkansas,5143,74674,646,75320
8/21/2022,Van Buren,Arkansas,5141,3883,62,3945
8/21/2022,Unknown,Arkansas,,30212,0,30212
8/21/2022,Union,Arkansas,5139,10352,186,10538
8/21/2022,Stone,Arkansas,5137,3276,69,3345
8/21/2022,St. Francis,Arkansas,5123,7906,98,8004
8/21/2022,Sharp,Arkansas,5135,5207,113,5320
8/21/2022,Sevier,Arkansas,5133,6629,76,6705
8/21/2022,Sebastian,Arkansas,5131,36304,547,36851
8/21/2022,Campbell,Virginia,51031,15134,225,15359
8/21/2022,Searcy,Arkansas,5129,2317,51,2368
8/21/2022,Scott,Arkansas,5127,2635,45,2680
8/21/2022,Saline,Arkansas,5125,34088,351,34439
8/21/2022,Randolph,Arkansas,5121,5717,96,5813
8/21/2022,Caroline,Virginia,51033,8075,89,8164
8/21/2022,Pulaski,Arkansas,5119,117387,1221,118608
8/21/2022,Prairie,Arkansas,5117,2160,43,2203
8/21/2022,Pope,Arkansas,5115,19806,216,20022
8/21/2022,Polk,Arkansas,5113,4409,151,4560
8/21/2022,Poinsett,Arkansas,5111,8985,132,9117
8/21/2022,Pike,Arkansas,5109,2761,44,2805
8/21/2022,Phillips,Arkansas,5107,5290,100,5390
8/21/2022,Perry,Arkansas,5105,2777,38,2815
8/21/2022,Ouachita,Arkansas,5103,6193,110,6303
8/21/2022,Newton,Arkansas,5101,1864,49,1913
8/21/2022,Nevada,Arkansas,5099,2458,45,2503
8/21/2022,Montgomery,Arkansas,5097,1668,57,1725
8/21/2022,Monroe,Arkansas,5095,2135,37,2172
8/21/2022,Mississippi,Arkansas,5093,14843,215,15058
8/21/2022,Miller,Arkansas,5091,10675,185,10860
8/21/2022,Page,Virginia,51139,6143,124,6267
8/21/2022,Carroll,Virginia,51035,7860,153,8013
8/21/2022,Charles City,Virginia,51036,1357,31,1388
8/21/2022,Patrick,Virginia,51141,4236,97,4333
8/21/2022,Warren,Virginia,51187,9900,161,10061
8/21/2022,Marion,Arkansas,5089,3750,90,3840
8/21/2022,Madison,Arkansas,5087,4414,65,4479
8/21/2022,Lonoke,Arkansas,5085,22053,253,22306
8/21/2022,Logan,Arkansas,5083,5567,80,5647
8/21/2022,Little River,Arkansas,5081,3570,106,3676
8/21/2022,Lincoln,Arkansas,5079,5177,69,5246
8/21/2022,Lee,Arkansas,5077,3173,62,3235
8/21/2022,Charlotte,Virginia,51037,2891,45,2936
8/21/2022,Lawrence,Arkansas,5075,5887,83,5970
8/21/2022,Lafayette,Arkansas,5073,1405,30,1435
8/21/2022,Johnson,Arkansas,5071,7465,90,7555
8/21/2022,Albany,Wyoming,56001,10892,51,10943
8/21/2022,Jefferson,Arkansas,5069,20628,286,20914
8/21/2022,Jackson,Arkansas,5067,6604,67,6671
8/21/2022,Izard,Arkansas,5065,4292,75,4367
8/21/2022,Independence,Arkansas,5063,11671,216,11887
8/21/2022,Howard,Arkansas,5061,4240,53,4293
8/21/2022,Hot Spring,Arkansas,5059,12215,145,12360
8/21/2022,Hempstead,Arkansas,5057,5170,73,5243
8/21/2022,Greene,Arkansas,5055,17637,183,17820
8/21/2022,Grant,Arkansas,5053,4841,62,4903
8/21/2022,Charlottesville city,Virginia,51540,11281,82,11363
8/21/2022,Garland,Arkansas,5051,25173,523,25696
8/21/2022,Fulton,Arkansas,5049,2892,95,2987
8/21/2022,Chesapeake city,Virginia,51550,57652,526,58178
8/21/2022,Franklin,Arkansas,5047,4129,74,4203
8/21/2022,Chesterfield,Virginia,51041,87988,795,88783
8/21/2022,Faulkner,Arkansas,5045,39242,329,39571
8/21/2022,Drew,Arkansas,5043,5050,72,5122
8/21/2022,Desha,Arkansas,5041,3378,41,3419
8/21/2022,Dallas,Arkansas,5039,1909,34,1943
8/21/2022,Cross,Arkansas,5037,5348,89,5437
8/21/2022,Crittenden,Arkansas,5035,15609,231,15840
8/21/2022,Crawford,Arkansas,5033,17362,260,17622
8/21/2022,Craighead,Arkansas,5031,41954,347,42301
8/21/2022,Conway,Arkansas,5029,5925,68,5993
8/21/2022,Columbia,Arkansas,5027,6041,99,6140
8/21/2022,Cleveland,Arkansas,5025,2463,39,2502
8/21/2022,Clarke,Virginia,51043,3095,52,3147
8/21/2022,Cleburne,Arkansas,5023,7294,133,7427
8/21/2022,Petersburg city,Virginia,51730,9336,142,9478
8/21/2022,Washington,Virginia,51191,15926,223,16149
8/21/2022,Clay,Arkansas,5021,4562,96,4658
8/21/2022,Clark,Arkansas,5019,5945,86,6031
8/21/2022,Columbia,Wisconsin,55021,17697,134,17831
8/21/2022,Pittsylvania,Virginia,51143,16332,218,16550
8/21/2022,Waynesboro city,Virginia,51820,6271,69,6340
8/21/2022,Grant,Wisconsin,55043,14210,153,14363
8/21/2022,Oneida,Wisconsin,55085,9760,140,9900
8/21/2022,Poquoson city,Virginia,51735,2669,31,2700
8/21/2022,Converse,Wyoming,56009,3398,56,3454
8/21/2022,Wahkiakum,Washington,53069,596,9,605
8/21/2022,Westmoreland,Virginia,51193,3685,55,3740
8/21/2022,Colonial Heights city,Virginia,51570,5749,103,5852
8/21/2022,Covington city,Virginia,51580,1618,28,1646
8/21/2022,Portsmouth city,Virginia,51740,23820,345,24165
8/21/2022,Powhatan,Virginia,51145,5831,63,5894
8/21/2022,Craig,Virginia,51045,1233,22,1255
8/21/2022,Culpeper,Virginia,51047,12816,158,12974
8/21/2022,Prince Edward,Virginia,51147,5781,77,5858
8/21/2022,Prince George,Virginia,51149,10288,82,10370
8/21/2022,Cumberland,Virginia,51049,1589,27,1616
8/21/2022,Danville city,Virginia,51590,12826,286,13112
8/21/2022,Randolph,West Virginia,54083,10651,93,10744
8/21/2022,Dickenson,Virginia,51051,3873,53,3926
8/21/2022,Dinwiddie,Virginia,51053,6276,96,6372
8/21/2022,Chicot,Arkansas,5017,2947,59,3006
8/21/2022,Carroll,Arkansas,5015,6734,112,6846
8/21/2022,Carbon,Wyoming,56007,4829,53,4882
8/21/2022,Weston,Wyoming,56045,1765,20,1785
8/21/2022,Green,Wisconsin,55045,10463,56,10519
8/21/2022,Crook,Wyoming,56011,1460,29,1489
8/21/2022,Green Lake,Wisconsin,55047,5763,65,5828
8/21/2022,Calhoun,Arkansas,5013,1092,11,1103
8/21/2022,Bradley,Arkansas,5011,3296,54,3350
8/21/2022,Boone,Arkansas,5009,10311,184,10495
8/21/2022,Benton,Arkansas,5007,72117,885,73002
8/21/2022,Baxter,Arkansas,5005,9849,266,10115
8/21/2022,Ashley,Arkansas,5003,5632,73,5705
8/21/2022,Emporia city,Virginia,51595,1460,55,1515
8/21/2022,Essex,Virginia,51057,2505,36,2541
8/21/2022,Arkansas,Arkansas,5001,6348,80,6428
8/21/2022,Yuma,Arizona,4027,66857,1194,68051
8/21/2022,Yavapai,Arizona,4025,53939,1258,55197
8/21/2022,Santa Cruz,Arizona,4023,18163,237,18400
8/21/2022,Pinal,Arizona,4021,145126,1711,146837
8/21/2022,Pima,Arizona,4019,285087,3947,289034
8/21/2022,Navajo,Arizona,4017,43238,929,44167
8/21/2022,Mohave,Arizona,4015,63221,1518,64739
8/21/2022,Maricopa,Arizona,4013,1406462,17726,1424188
8/21/2022,La Paz,Arizona,4012,5695,148,5843
8/21/2022,Greenlee,Arizona,4011,2433,39,2472
8/21/2022,Graham,Arizona,4009,13164,182,13346
8/21/2022,Gila,Arizona,4007,19363,392,19755
8/21/2022,Coconino,Arizona,4005,48900,491,49391
8/21/2022,Cochise,Arizona,4003,35375,590,35965
8/21/2022,Apache,Arizona,4001,30185,620,30805
8/21/2022,Unknown,American Samoa,,7471,33,7504
8/21/2022,Yukon-Koyukuk Census Area,Alaska,2290,1614,11,1625
8/21/2022,Yakutat plus Hoonah-Angoon,Alaska,,843,5,848
8/21/2022,Wrangell City and Borough,Alaska,2275,757,1,758
8/21/2022,Valdez-Cordova Census Area,Alaska,2261,3505,21,3526
8/21/2022,Fairfax,Virginia,51059,228080,1535,229615
8/21/2022,Fairfax city,Virginia,51600,2329,45,2374
8/21/2022,Falls Church city,Virginia,51610,3004,18,3022
8/21/2022,Unknown,Alaska,,7457,1,7458
8/21/2022,Fauquier,Virginia,51061,14828,153,14981
8/21/2022,Southeast Fairbanks Census Area,Alaska,2240,2281,20,2301
8/21/2022,Skagway Municipality,Alaska,2230,613,0,613
8/21/2022,Sitka City and Borough,Alaska,2220,3205,6,3211
8/21/2022,Prince of Wales-Hyder Census Area,Alaska,2198,1714,10,1724
8/21/2022,Petersburg Borough,Alaska,2195,873,5,878
8/21/2022,Northwest Arctic Borough,Alaska,2188,5230,15,5245
8/21/2022,Floyd,Virginia,51063,2892,50,2942
8/21/2022,North Slope Borough,Alaska,2185,5113,14,5127
8/21/2022,Walla Walla,Washington,53071,18183,164,18347
8/21/2022,Rock,Wisconsin,55105,49388,405,49793
8/21/2022,Whatcom,Washington,53073,45593,325,45918
8/21/2022,Wood,West Virginia,54107,25311,357,25668
8/21/2022,Nome Census Area,Alaska,2180,6568,5,6573
8/21/2022,Matanuska-Susitna Borough,Alaska,2170,38728,245,38973
8/21/2022,Kusilvak Census Area,Alaska,2158,4480,14,4494
8/21/2022,Kodiak Island Borough,Alaska,2150,5547,12,5559
8/21/2022,Fluvanna,Virginia,51065,6142,48,6190
8/21/2022,Ketchikan Gateway Borough,Alaska,2130,4921,21,4942
8/21/2022,Franklin,Virginia,51067,12527,205,12732
8/21/2022,Kenai Peninsula Borough,Alaska,2122,21105,105,21210
8/21/2022,Franklin city,Virginia,51620,2503,53,2556
8/21/2022,Juneau City and Borough,Alaska,2110,11026,21,11047
8/21/2022,Frederick,Virginia,51069,23585,259,23844
8/21/2022,Big Horn,Wyoming,56003,2868,64,2932
8/21/2022,Haines Borough,Alaska,2100,764,1,765
8/21/2022,Fairbanks North Star Borough,Alaska,2090,31518,149,31667
8/21/2022,Dillingham Census Area,Alaska,2070,2099,12,2111
8/21/2022,Denali Borough,Alaska,2068,1627,1,1628
8/21/2022,Marion,Tennessee,47115,9803,134,9937
8/21/2022,Bristol Bay plus Lake and Peninsula,Alaska,,1176,1,1177
8/21/2022,Bethel Census Area,Alaska,2050,11685,42,11727
8/21/2022,Anchorage,Alaska,2020,117697,547,118244
8/21/2022,Aleutians West Census Area,Alaska,2016,1863,2,1865
8/21/2022,Aleutians East Borough,Alaska,2013,1197,3,1200
8/21/2022,Marshall,Tennessee,47117,11198,125,11323
8/21/2022,Winston,Alabama,1133,8315,134,8449
8/21/2022,Wilcox,Alabama,1131,3299,48,3347
8/21/2022,Washington,Alabama,1129,4080,59,4139
8/21/2022,Walker,Alabama,1127,21141,456,21597
8/21/2022,Tuscaloosa,Alabama,1125,63196,804,64000
8/21/2022,Sawyer,Wisconsin,55113,5345,63,5408
8/21/2022,Maury,Tennessee,47119,31898,360,32258
8/21/2022,Madison,Tennessee,47113,33844,447,34291
8/21/2022,Macon,Tennessee,47111,9167,150,9317
8/21/2022,McMinn,Tennessee,47107,18032,270,18302
8/21/2022,Loudon,Tennessee,47105,16147,197,16344
8/21/2022,McNairy,Tennessee,47109,8451,129,8580
8/21/2022,Lincoln,Tennessee,47103,10619,178,10797
8/21/2022,Lewis,Tennessee,47101,3760,63,3823
8/21/2022,Lawrence,Tennessee,47099,15388,211,15599
8/21/2022,Lauderdale,Tennessee,47097,8387,109,8496
8/21/2022,Lake,Tennessee,47095,2891,44,2935
8/21/2022,Knox,Tennessee,47093,142157,1461,143618
8/21/2022,Johnson,Tennessee,47091,5513,99,5612
8/21/2022,Jefferson,Tennessee,47089,17187,279,17466
8/21/2022,Jackson,Tennessee,47087,3447,65,3512
8/21/2022,Humphreys,Tennessee,47085,5289,78,5367
8/21/2022,Meigs,Tennessee,47121,3710,59,3769
8/21/2022,Houston,Tennessee,47083,2800,62,2862
8/21/2022,Hickman,Tennessee,47081,7494,114,7608
8/21/2022,Henry,Tennessee,47079,9014,165,9179
8/21/2022,Henderson,Tennessee,47077,9792,168,9960
8/21/2022,Haywood,Tennessee,47075,6878,105,6983
8/21/2022,Hawkins,Tennessee,47073,18323,333,18656
8/21/2022,Hardin,Tennessee,47071,9705,161,9866
8/21/2022,Hardeman,Tennessee,47069,8337,122,8459
8/21/2022,Hancock,Tennessee,47067,2252,39,2291
8/21/2022,Hamilton,Tennessee,47065,112043,1203,113246
8/21/2022,Hamblen,Tennessee,47063,21661,374,22035
8/21/2022,Grundy,Tennessee,47061,4312,75,4387
8/21/2022,Greene,Tennessee,47059,24302,385,24687
8/21/2022,Grainger,Tennessee,47057,7337,111,7448
8/21/2022,Giles,Tennessee,47055,10362,200,10562
8/21/2022,Gibson,Tennessee,47053,19164,267,19431
8/21/2022,Franklin,Tennessee,47051,14011,193,14204
8/21/2022,Fentress,Tennessee,47049,6211,130,6341
8/21/2022,Fayette,Tennessee,47047,12629,191,12820
8/21/2022,Dyer,Tennessee,47045,14024,213,14237
8/21/2022,Dickson,Tennessee,47043,17524,251,17775
8/21/2022,DeKalb,Tennessee,47041,6794,104,6898
8/21/2022,Monroe,Tennessee,47123,15847,251,16098
8/21/2022,Decatur,Tennessee,47039,4004,71,4075
8/21/2022,Davidson,Tennessee,47037,234061,1732,235793
8/21/2022,Cumberland,Tennessee,47035,17606,335,17941
8/21/2022,Crockett,Tennessee,47033,5638,88,5726
8/21/2022,Coffee,Tennessee,47031,18544,276,18820
8/21/2022,Cocke,Tennessee,47029,12851,229,13080
8/21/2022,Montgomery,Tennessee,47125,55804,598,56402
8/21/2022,Clay,Tennessee,47027,2443,52,2495
8/21/2022,Claiborne,Tennessee,47025,9695,188,9883
8/21/2022,Chester,Tennessee,47023,6340,100,6440
8/21/2022,Moore,Tennessee,47127,2405,40,2445
8/21/2022,Cheatham,Tennessee,47021,11825,132,11957
8/21/2022,Carter,Tennessee,47019,18205,346,18551
8/21/2022,Carroll,Tennessee,47017,10018,160,10178
8/21/2022,Cannon,Tennessee,47015,4588,68,4656
8/21/2022,Campbell,Tennessee,47013,13695,174,13869
8/21/2022,Bradley,Tennessee,47011,35832,428,36260
8/21/2022,Blount,Tennessee,47009,43381,465,43846
8/21/2022,Bledsoe,Tennessee,47007,4902,61,4963
8/21/2022,Benton,Tennessee,47005,4990,96,5086
8/21/2022,Bedford,Tennessee,47003,16231,242,16473
8/21/2022,Anderson,Tennessee,47001,24432,357,24789
8/21/2022,Ziebach,South Dakota,46137,686,11,697
8/21/2022,Yankton,South Dakota,46135,6334,59,6393
8/21/2022,Walworth,South Dakota,46129,1407,26,1433
8/21/2022,Union,South Dakota,46127,4143,52,4195
8/21/2022,Turner,South Dakota,46125,2074,62,2136
8/21/2022,Tripp,South Dakota,46123,1499,26,1525
8/21/2022,Todd,South Dakota,46121,3238,52,3290
8/21/2022,Sully,South Dakota,46119,255,3,258
8/21/2022,Morgan,Tennessee,47129,6771,88,6859
8/21/2022,Obion,Tennessee,47131,11810,203,12013
8/21/2022,Overton,Tennessee,47133,7734,126,7860
8/21/2022,Perry,Tennessee,47135,2526,56,2582
8/21/2022,Stanley,South Dakota,46117,677,8,685
8/21/2022,Spink,South Dakota,46115,1525,36,1561
8/21/2022,Pickett,Tennessee,47137,1945,38,1983
8/21/2022,Sanborn,South Dakota,46111,622,8,630
8/21/2022,Roberts,South Dakota,46109,2599,53,2652
8/21/2022,Potter,South Dakota,46107,731,7,738
8/21/2022,Polk,Tennessee,47139,5108,83,5191
8/21/2022,Perkins,South Dakota,46105,743,19,762
8/21/2022,Pennington,South Dakota,46103,35860,353,36213
8/21/2022,Oglala Lakota,South Dakota,46102,4306,61,4367
8/21/2022,Moody,South Dakota,46101,1512,28,1540
8/21/2022,Minnehaha,South Dakota,46099,60427,529,60956
8/21/2022,Miner,South Dakota,46097,487,13,500
8/21/2022,Mellette,South Dakota,46095,554,8,562
8/21/2022,Meade,South Dakota,46093,7665,65,7730
8/21/2022,McPherson,South Dakota,46089,451,9,460
8/21/2022,McCook,South Dakota,46087,1413,31,1444
8/21/2022,Marshall,South Dakota,46091,855,14,869
8/21/2022,Putnam,Tennessee,47141,27032,308,27340
8/21/2022,Lyman,South Dakota,46085,1295,13,1308
8/21/2022,Lincoln,South Dakota,46083,16311,103,16414
8/21/2022,Lawrence,South Dakota,46081,7251,86,7337
8/21/2022,Lake,South Dakota,46079,2454,28,2482
8/21/2022,Rhea,Tennessee,47143,10763,164,10927
8/21/2022,Kingsbury,South Dakota,46077,1398,22,1420
8/21/2022,Jones,South Dakota,46075,184,2,186
8/21/2022,Jerauld,South Dakota,46073,432,20,452
8/21/2022,Jackson,South Dakota,46071,659,21,680
8/21/2022,Hyde,South Dakota,46069,323,8,331
8/21/2022,Hutchinson,South Dakota,46067,1845,36,1881
8/21/2022,Hughes,South Dakota,46065,4626,61,4687
8/21/2022,Harding,South Dakota,46063,210,3,213
8/21/2022,Hanson,South Dakota,46061,684,6,690
8/21/2022,Hand,South Dakota,46059,612,13,625
8/21/2022,Hamlin,South Dakota,46057,1658,41,1699
8/21/2022,Haakon,South Dakota,46055,489,12,501
8/21/2022,Gregory,South Dakota,46053,1128,34,1162
8/21/2022,Grant,South Dakota,46051,2166,51,2217
8/21/2022,Faulk,South Dakota,46049,609,17,626
8/21/2022,Fall River,South Dakota,46047,2114,40,2154
8/21/2022,Roane,Tennessee,47145,17323,242,17565
8/21/2022,Edmunds,South Dakota,46045,994,16,1010
8/21/2022,Robertson,Tennessee,47147,23266,319,23585
8/21/2022,Douglas,South Dakota,46043,726,16,742
8/21/2022,Dewey,South Dakota,46041,3232,44,3276
8/21/2022,Deuel,South Dakota,46039,1097,12,1109
8/21/2022,Day,South Dakota,46037,1355,35,1390
8/21/2022,Davison,South Dakota,46035,6297,81,6378
8/21/2022,Rutherford,Tennessee,47149,106183,926,107109
8/21/2022,Custer,South Dakota,46033,2287,27,2314
8/21/2022,Corson,South Dakota,46031,1113,17,1130
8/21/2022,Codington,South Dakota,46029,9284,102,9386
8/21/2022,Clay,South Dakota,46027,3653,24,3677
8/21/2022,Clark,South Dakota,46025,868,10,878
8/21/2022,Charles Mix,South Dakota,46023,3111,35,3146
8/21/2022,Scott,Tennessee,47151,10256,123,10379
8/21/2022,Campbell,South Dakota,46021,290,7,297
8/21/2022,Tallapoosa,Alabama,1123,12917,244,13161
8/21/2022,Talladega,Alabama,1121,25029,381,25410
8/21/2022,Butte,South Dakota,46019,2975,47,3022
8/21/2022,Buffalo,South Dakota,46017,645,18,663
8/21/2022,Brule,South Dakota,46015,1543,22,1565
8/21/2022,Brown,South Dakota,46013,10946,124,11070
8/21/2022,Brookings,South Dakota,46011,8687,58,8745
8/21/2022,Bon Homme,South Dakota,46009,2371,40,2411
8/21/2022,Bennett,South Dakota,46007,834,15,849
8/21/2022,Beadle,South Dakota,46005,5006,62,5068
8/21/2022,Aurora,South Dakota,46003,845,17,862
8/21/2022,York,South Carolina,45091,86492,695,87187
8/21/2022,Williamsburg,South Carolina,45089,9388,146,9534
8/21/2022,Union,South Carolina,45087,8573,154,8727
8/21/2022,Sumter,South Carolina,45085,31875,406,32281
8/21/2022,Spartanburg,South Carolina,45083,104645,1565,106210
8/21/2022,Saluda,South Carolina,45081,4219,78,4297
8/21/2022,Richland,South Carolina,45079,143109,968,144077
8/21/2022,Pickens,South Carolina,45077,49508,640,50148
8/21/2022,Orangeburg,South Carolina,45075,26591,426,27017
8/21/2022,Oconee,South Carolina,45073,26341,351,26692
8/21/2022,Newberry,South Carolina,45071,14721,202,14923
8/21/2022,McCormick,South Carolina,45065,2473,40,2513
8/21/2022,Marlboro,South Carolina,45069,8914,107,9021
8/21/2022,Marion,South Carolina,45067,9685,166,9851
8/21/2022,Lexington,South Carolina,45063,109228,896,110124
8/21/2022,Sequatchie,Tennessee,47153,4608,70,4678
8/21/2022,Lee,South Carolina,45061,4684,96,4780
8/21/2022,Laurens,South Carolina,45059,20394,299,20693
8/21/2022,Lancaster,South Carolina,45057,28259,286,28545
8/21/2022,Kershaw,South Carolina,45055,24518,266,24784
8/21/2022,Jasper,South Carolina,45053,6593,95,6688
8/21/2022,Horry,South Carolina,45051,109685,1197,110882
8/21/2022,Hampton,South Carolina,45049,5482,86,5568
8/21/2022,Sevier,Tennessee,47155,33061,429,33490
8/21/2022,Shelby,Tennessee,47157,269994,3445,273439
8/21/2022,Smith,Tennessee,47159,6560,89,6649
8/21/2022,Stewart,Tennessee,47161,3477,63,3540
8/21/2022,Greenwood,South Carolina,45047,24413,312,24725
8/21/2022,Greenville,South Carolina,45045,188631,2036,190667
8/21/2022,Sullivan,Tennessee,47163,51303,747,52050
8/21/2022,Georgetown,South Carolina,45043,17888,232,18120
8/21/2022,Sumner,Tennessee,47165,58898,760,59658
8/21/2022,Florence,South Carolina,45041,46298,651,46949
8/21/2022,Fairfield,South Carolina,45039,6743,110,6853
8/21/2022,Edgefield,South Carolina,45037,7502,72,7574
8/21/2022,Tipton,Tennessee,47167,19541,243,19784
8/21/2022,Dorchester,South Carolina,45035,63614,511,64125
8/21/2022,Dillon,South Carolina,45033,10679,146,10825
8/21/2022,Darlington,South Carolina,45031,20658,319,20977
8/21/2022,Colleton,South Carolina,45029,10072,222,10294
8/21/2022,Clarendon,South Carolina,45027,9820,164,9984
8/21/2022,Chesterfield,South Carolina,45025,13271,196,13467
8/21/2022,Chester,South Carolina,45023,11169,155,11324
8/21/2022,Cherokee,South Carolina,45021,16409,324,16733
8/21/2022,Charleston,South Carolina,45019,127377,974,128351
8/21/2022,Calhoun,South Carolina,45017,3158,61,3219
8/21/2022,Berkeley,South Carolina,45015,59744,456,60200
8/21/2022,Beaufort,South Carolina,45013,48852,389,49241
8/21/2022,Barnwell,South Carolina,45011,6302,103,6405
8/21/2022,Bamberg,South Carolina,45009,3910,75,3985
8/21/2022,Anderson,South Carolina,45007,62897,1019,63916
8/21/2022,Trousdale,Tennessee,47169,4430,47,4477
8/21/2022,Allendale,South Carolina,45005,2267,24,2291
8/21/2022,Aiken,South Carolina,45003,46584,442,47026
8/21/2022,Abbeville,South Carolina,45001,7113,69,7182
8/21/2022,Washington,Rhode Island,44009,38739,243,38982
8/21/2022,Unknown,Rhode Island,,28551,3,28554
8/21/2022,Providence,Rhode Island,44007,250643,2590,253233
8/21/2022,Newport,Rhode Island,44005,23780,98,23878
8/21/2022,Unicoi,Tennessee,47171,5670,97,5767
8/21/2022,Union,Tennessee,47173,6074,79,6153
8/21/2022,Kent,Rhode Island,44003,57179,523,57702
8/21/2022,Bristol,Rhode Island,44001,16039,179,16218
8/21/2022,Yauco,Puerto Rico,72153,9290,,9290
8/21/2022,Yabucoa,Puerto Rico,72151,8680,,8680
8/21/2022,Unknown,Tennessee,,29052,349,29401
8/21/2022,Villalba,Puerto Rico,72149,6388,,6388
8/21/2022,Vieques,Puerto Rico,72147,1618,,1618
8/21/2022,Van Buren,Tennessee,47175,1998,48,2046
8/21/2022,Warren,Tennessee,47177,14106,183,14289
8/21/2022,Vega Baja,Puerto Rico,72145,17337,,17337
8/21/2022,Vega Alta,Puerto Rico,72143,10495,,10495
8/21/2022,Utuado,Puerto Rico,72141,6580,,6580
8/21/2022,Unknown,Puerto Rico,,32622,4906,37528
8/21/2022,Trujillo Alto,Puerto Rico,72139,16704,,16704
8/21/2022,Toa Baja,Puerto Rico,72137,21115,,21115
8/21/2022,Toa Alta,Puerto Rico,72135,19318,,19318
8/21/2022,Santa Isabel,Puerto Rico,72133,5527,,5527
8/21/2022,San Sebastian,Puerto Rico,72131,11582,,11582
8/21/2022,San Lorenzo,Puerto Rico,72129,10044,,10044
8/21/2022,San Juan,Puerto Rico,72127,89724,,89724
8/21/2022,San German,Puerto Rico,72125,7743,,7743
8/21/2022,Salinas,Puerto Rico,72123,6677,,6677
8/21/2022,Sabana Grande,Puerto Rico,72121,5292,,5292
8/21/2022,Rio Grande,Puerto Rico,72119,12418,,12418
8/21/2022,Rincon,Puerto Rico,72117,3697,,3697
8/21/2022,Quebradillas,Puerto Rico,72115,7290,,7290
8/21/2022,Ponce,Puerto Rico,72113,33701,,33701
8/21/2022,Penuelas,Puerto Rico,72111,4740,,4740
8/21/2022,Patillas,Puerto Rico,72109,4483,,4483
8/21/2022,Orocovis,Puerto Rico,72107,5541,,5541
8/21/2022,Washington,Tennessee,47179,42839,508,43347
8/21/2022,Naranjito,Puerto Rico,72105,8433,,8433
8/21/2022,Naguabo,Puerto Rico,72103,6162,,6162
8/21/2022,Morovis,Puerto Rico,72101,8019,,8019
8/21/2022,Moca,Puerto Rico,72099,11018,,11018
8/21/2022,Mayaguez,Puerto Rico,72097,18513,,18513
8/21/2022,Maunabo,Puerto Rico,72095,2700,,2700
8/21/2022,Maricao,Puerto Rico,72093,1274,,1274
8/21/2022,Sumter,Alabama,1119,2882,52,2934
8/21/2022,Fredericksburg city,Virginia,51630,6310,41,6351
8/21/2022,Manati,Puerto Rico,72091,10756,,10756
8/21/2022,Luquillo,Puerto Rico,72089,4537,,4537
8/21/2022,Loiza,Puerto Rico,72087,5166,,5166
8/21/2022,Las Piedras,Puerto Rico,72085,10117,,10117
8/21/2022,Las Marias,Puerto Rico,72083,2455,,2455
8/21/2022,Lares,Puerto Rico,72081,8565,,8565
8/21/2022,Lajas,Puerto Rico,72079,5666,,5666
8/21/2022,Juncos,Puerto Rico,72077,10996,,10996
8/21/2022,Juana Diaz,Puerto Rico,72075,12084,,12084
8/21/2022,Jayuya,Puerto Rico,72073,4534,,4534
8/21/2022,Isabela,Puerto Rico,72071,11884,,11884
8/21/2022,Humacao,Puerto Rico,72069,14140,,14140
8/21/2022,Hormigueros,Puerto Rico,72067,4167,,4167
8/21/2022,Hatillo,Puerto Rico,72065,9716,,9716
8/21/2022,Gurabo,Puerto Rico,72063,12650,,12650
8/21/2022,Guaynabo,Puerto Rico,72061,26598,,26598
8/21/2022,Guayanilla,Puerto Rico,72059,4710,,4710
8/21/2022,Guayama,Puerto Rico,72057,9753,,9753
8/21/2022,Guanica,Puerto Rico,72055,2981,,2981
8/21/2022,Florida,Puerto Rico,72054,4164,,4164
8/21/2022,Fajardo,Puerto Rico,72053,8422,,8422
8/21/2022,Dorado,Puerto Rico,72051,11042,,11042
8/21/2022,Culebra,Puerto Rico,72049,436,,436
8/21/2022,Corozal,Puerto Rico,72047,10667,,10667
8/21/2022,Wayne,Tennessee,47181,6108,75,6183
8/21/2022,Weakley,Tennessee,47183,10327,165,10492
8/21/2022,Comerio,Puerto Rico,72045,5165,,5165
8/21/2022,Coamo,Puerto Rico,72043,9704,,9704
8/21/2022,Cidra,Puerto Rico,72041,11798,,11798
8/21/2022,Ciales,Puerto Rico,72039,4454,,4454
8/21/2022,Ceiba,Puerto Rico,72037,2789,,2789
8/21/2022,Cayey,Puerto Rico,72035,12037,,12037
8/21/2022,Catano,Puerto Rico,72033,6421,,6421
8/21/2022,Carolina,Puerto Rico,72031,44964,,44964
8/21/2022,St. Clair,Alabama,1115,28689,425,29114
8/21/2022,Canovanas,Puerto Rico,72029,11286,,11286
8/21/2022,Camuy,Puerto Rico,72027,9164,,9164
8/21/2022,Caguas,Puerto Rico,72025,37835,,37835
8/21/2022,Cabo Rojo,Puerto Rico,72023,10922,,10922
8/21/2022,Bayamon,Puerto Rico,72021,57193,,57193
8/21/2022,White,Tennessee,47185,8845,132,8977
8/21/2022,Barranquitas,Puerto Rico,72019,8259,,8259
8/21/2022,Barceloneta,Puerto Rico,72017,6416,,6416
8/21/2022,Arroyo,Puerto Rico,72015,4579,,4579
8/21/2022,Shelby,Alabama,1117,68196,465,68661
8/21/2022,Arecibo,Puerto Rico,72013,22525,,22525
8/21/2022,Williamsburg city,Virginia,51830,2026,23,2049
8/21/2022,Williamson,Tennessee,47187,69309,417,69726
8/21/2022,Anasco,Puerto Rico,72011,6823,,6823
8/21/2022,Wilson,Tennessee,47189,46253,505,46758
8/21/2022,Aibonito,Puerto Rico,72009,6884,,6884
8/21/2022,Aguas Buenas,Puerto Rico,72007,6996,,6996
8/21/2022,Aguadilla,Puerto Rico,72005,13208,,13208
8/21/2022,Aguada,Puerto Rico,72003,10904,,10904
8/21/2022,Adjuntas,Puerto Rico,72001,5286,,5286
8/21/2022,York,Pennsylvania,42133,131492,1547,133039
8/21/2022,Wyoming,Pennsylvania,42131,5762,114,5876
8/21/2022,Westmoreland,Pennsylvania,42129,89188,1431,90619
8/21/2022,Wayne,Pennsylvania,42127,11472,177,11649
8/21/2022,Washington,Pennsylvania,42125,57554,679,58233
8/21/2022,Warren,Pennsylvania,42123,8273,219,8492
8/21/2022,Venango,Pennsylvania,42121,12341,250,12591
8/21/2022,Union,Pennsylvania,42119,12574,157,12731
8/21/2022,Tioga,Pennsylvania,42117,8978,200,9178
8/21/2022,Susquehanna,Pennsylvania,42115,8874,116,8990
8/21/2022,Sullivan,Pennsylvania,42113,1222,36,1258
8/21/2022,Somerset,Pennsylvania,42111,20300,416,20716
8/21/2022,Snyder,Pennsylvania,42109,8755,160,8915
8/21/2022,Schuylkill,Pennsylvania,42107,37773,706,38479
8/21/2022,Potter,Pennsylvania,42105,3490,94,3584
8/21/2022,Pike,Pennsylvania,42103,11634,103,11737
8/21/2022,Philadelphia,Pennsylvania,42101,354168,5232,359400
8/21/2022,Perry,Pennsylvania,42099,9528,191,9719
8/21/2022,Northumberland,Pennsylvania,42097,25348,555,25903
8/21/2022,Northampton,Pennsylvania,42095,89295,1149,90444
8/21/2022,Montour,Pennsylvania,42093,5225,94,5319
8/21/2022,Montgomery,Pennsylvania,42091,178388,2419,180807
8/21/2022,Monroe,Pennsylvania,42089,42336,551,42887
8/21/2022,Mifflin,Pennsylvania,42087,13331,284,13615
8/21/2022,Wyoming,West Virginia,54109,8208,125,8333
8/21/2022,Galax city,Virginia,51640,3001,79,3080
8/21/2022,Mercer,Pennsylvania,42085,25702,514,26216
8/21/2022,McKean,Pennsylvania,42083,8821,153,8974
8/21/2022,Lycoming,Pennsylvania,42081,31389,549,31938
8/21/2022,Luzerne,Pennsylvania,42079,82986,1453,84439
8/21/2022,Lehigh,Pennsylvania,42077,99936,1287,101223
8/21/2022,Lebanon,Pennsylvania,42075,40394,531,40925
8/21/2022,Lawrence,Pennsylvania,42073,20804,431,21235
8/21/2022,Lancaster,Pennsylvania,42071,133524,1954,135478
8/21/2022,Lackawanna,Pennsylvania,42069,50820,814,51634
8/21/2022,Juniata,Pennsylvania,42067,5139,183,5322
8/21/2022,Jefferson,Pennsylvania,42065,9884,247,10131
8/21/2022,Indiana,Pennsylvania,42063,19319,372,19691
8/21/2022,Huntingdon,Pennsylvania,42061,12457,259,12716
8/21/2022,Greene,Pennsylvania,42059,9398,110,9508
8/21/2022,Fulton,Pennsylvania,42057,4516,66,4582
8/21/2022,Franklin,Pennsylvania,42055,44934,723,45657
8/21/2022,Forest,Pennsylvania,42053,2401,36,2437
8/21/2022,Fayette,Pennsylvania,42051,34585,697,35282
8/21/2022,Erie,Pennsylvania,42049,64103,803,64906
8/21/2022,Elk,Pennsylvania,42047,7757,107,7864
8/21/2022,Delaware,Pennsylvania,42045,126761,1917,128678
8/21/2022,Dauphin,Pennsylvania,42043,65512,998,66510
8/21/2022,Cumberland,Pennsylvania,42041,56819,919,57738
8/21/2022,Crawford,Pennsylvania,42039,21887,336,22223
8/21/2022,Columbia,Pennsylvania,42037,17147,257,17404
8/21/2022,Clinton,Pennsylvania,42035,9975,131,10106
8/21/2022,Clearfield,Pennsylvania,42033,21399,361,21760
8/21/2022,Clarion,Pennsylvania,42031,8956,210,9166
8/21/2022,Chester,Pennsylvania,42029,105983,1209,107192
8/21/2022,Centre,Pennsylvania,42027,39556,363,39919
8/21/2022,Carbon,Pennsylvania,42025,17706,314,18020
8/21/2022,Cameron,Pennsylvania,42023,905,21,926
8/21/2022,Cambria,Pennsylvania,42021,38173,753,38926
8/21/2022,Butler,Pennsylvania,42019,49764,769,50533
8/21/2022,Bucks,Pennsylvania,42017,139934,1992,141926
8/21/2022,Bradford,Pennsylvania,42015,17743,215,17958
8/21/2022,Blair,Pennsylvania,42013,32023,639,32662
8/21/2022,Anderson,Texas,48001,10334,246,10580
8/21/2022,Berks,Pennsylvania,42011,113072,1648,114720
8/21/2022,Bedford,Pennsylvania,42009,11797,282,12079
8/21/2022,Beaver,Pennsylvania,42007,44618,769,45387
8/21/2022,Armstrong,Pennsylvania,42005,16603,359,16962
8/21/2022,Allegheny,Pennsylvania,42003,307180,3477,310657
8/21/2022,Andrews,Texas,48003,4472,72,4544
8/21/2022,Adams,Pennsylvania,42001,27791,386,28177
8/21/2022,Yamhill,Oregon,41071,20716,236,20952
8/21/2022,Wheeler,Oregon,41069,261,3,264
8/21/2022,Washington,Oregon,41067,110459,681,111140
8/21/2022,Wasco,Oregon,41065,6151,68,6219
8/21/2022,Wallowa,Oregon,41063,1413,19,1432
8/21/2022,Angelina,Texas,48005,16302,489,16791
8/21/2022,Unknown,Oregon,,2,0,2
8/21/2022,Aransas,Texas,48007,4981,91,5072
8/21/2022,Union,Oregon,41061,5514,87,5601
8/21/2022,Umatilla,Oregon,41059,24665,240,24905
8/21/2022,Tillamook,Oregon,41057,4577,71,4648
8/21/2022,Sherman,Oregon,41055,365,6,371
8/21/2022,Polk,Oregon,41053,18492,146,18638
8/21/2022,Multnomah,Oregon,41051,153087,1356,154443
8/21/2022,Archer,Texas,48009,2449,28,2477
8/21/2022,Morrow,Oregon,41049,3202,37,3239
8/21/2022,Marion,Oregon,41047,80736,774,81510
8/21/2022,Malheur,Oregon,41045,8985,112,9097
8/21/2022,Armstrong,Texas,48011,626,10,636
8/21/2022,Linn,Oregon,41043,30570,301,30871
8/21/2022,Lincoln,Oregon,41041,8443,101,8544
8/21/2022,Lane,Oregon,41039,71218,605,71823
8/21/2022,Lake,Oregon,41037,1549,31,1580
8/21/2022,Klamath,Oregon,41035,16359,241,16600
8/21/2022,Josephine,Oregon,41033,18721,361,19082
8/21/2022,Atascosa,Texas,48013,14811,233,15044
8/21/2022,Jefferson,Oregon,41031,8239,101,8340
8/21/2022,Jackson,Oregon,41029,49684,572,50256
8/21/2022,Austin,Texas,48015,6486,78,6564
8/21/2022,Hood River,Oregon,41027,4313,46,4359
8/21/2022,Bailey,Texas,48017,1673,39,1712
8/21/2022,Harney,Oregon,41025,1803,41,1844
8/21/2022,Grant,Oregon,41023,2030,23,2053
8/21/2022,Gilliam,Oregon,41021,309,6,315
8/21/2022,Douglas,Oregon,41019,23481,423,23904
8/21/2022,Deschutes,Oregon,41017,56513,323,56836
8/21/2022,Curry,Oregon,41015,4210,63,4273
8/21/2022,Crook,Oregon,41013,7171,89,7260
8/21/2022,Coos,Oregon,41011,13032,170,13202
8/21/2022,Columbia,Oregon,41009,9329,106,9435
8/21/2022,Clatsop,Oregon,41007,5784,56,5840
8/21/2022,Clackamas,Oregon,41005,75872,711,76583
8/21/2022,Benton,Oregon,41003,19876,82,19958
8/21/2022,Baker,Oregon,41001,3559,54,3613
8/21/2022,Woodward,Oklahoma,40153,5534,79,5613
8/21/2022,Woods,Oklahoma,40151,2480,39,2519
8/21/2022,Washita,Oklahoma,40149,2867,56,2923
8/21/2022,Washington,Oklahoma,40147,14003,264,14267
8/21/2022,Wagoner,Oklahoma,40145,24298,279,24577
8/21/2022,Bandera,Texas,48019,4003,78,4081
8/21/2022,Unknown,Oklahoma,,3380,0,3380
8/21/2022,Russell,Alabama,1113,11602,97,11699
8/21/2022,Tulsa,Oklahoma,40143,190382,2218,192600
8/21/2022,Tillman,Oklahoma,40141,1664,36,1700
8/21/2022,Texas,Oklahoma,40139,6386,56,6442
8/21/2022,Stephens,Oklahoma,40137,12182,210,12392
8/21/2022,Sequoyah,Oklahoma,40135,11754,108,11862
8/21/2022,Seminole,Oklahoma,40133,6863,136,6999
8/21/2022,Bastrop,Texas,48021,24901,243,25144
8/21/2022,Rogers,Oklahoma,40131,28028,393,28421
8/21/2022,Roger Mills,Oklahoma,40129,980,16,996
8/21/2022,Pushmataha,Oklahoma,40127,2926,45,2971
8/21/2022,Pottawatomie,Oklahoma,40125,23087,286,23373
8/21/2022,Pontotoc,Oklahoma,40123,13925,155,14080
8/21/2022,Pittsburg,Oklahoma,40121,12106,220,12326
8/21/2022,Payne,Oklahoma,40119,20402,172,20574
8/21/2022,Pawnee,Oklahoma,40117,4532,85,4617
8/21/2022,Ottawa,Oklahoma,40115,10313,127,10440
8/21/2022,Osage,Oklahoma,40113,12180,172,12352
8/21/2022,Okmulgee,Oklahoma,40111,10508,194,10702
8/21/2022,Oklahoma,Oklahoma,40109,221479,2517,223996
8/21/2022,Okfuskee,Oklahoma,40107,3823,63,3886
8/21/2022,Nowata,Oklahoma,40105,2961,42,3003
8/21/2022,Baylor,Texas,48023,880,33,913
8/21/2022,Bee,Texas,48025,9303,154,9457
8/21/2022,Noble,Oklahoma,40103,3271,42,3313
8/21/2022,Muskogee,Oklahoma,40101,21937,354,22291
8/21/2022,Murray,Oklahoma,40099,4621,79,4700
8/21/2022,Bell,Texas,48027,76744,919,77663
8/21/2022,McIntosh,Oklahoma,40091,5286,126,5412
8/21/2022,McCurtain,Oklahoma,40089,8740,166,8906
8/21/2022,McClain,Oklahoma,40087,12798,140,12938
8/21/2022,Mayes,Oklahoma,40097,11511,167,11678
8/21/2022,Marshall,Oklahoma,40095,5026,46,5072
8/21/2022,Major,Oklahoma,40093,2687,41,2728
8/21/2022,Love,Oklahoma,40085,3447,41,3488
8/21/2022,Logan,Oklahoma,40083,12118,165,12283
8/21/2022,Randolph,Alabama,1111,5561,75,5636
8/21/2022,Bexar,Texas,48029,638984,6263,645247
8/21/2022,Pike,Alabama,1109,8420,137,8557
8/21/2022,Blanco,Texas,48031,2906,35,2941
8/21/2022,Pickens,Alabama,1107,5723,106,5829
8/21/2022,Perry,Alabama,1105,2366,47,2413
8/21/2022,Lincoln,Oklahoma,40081,8769,144,8913
8/21/2022,Le Flore,Oklahoma,40079,13913,108,14021
8/21/2022,Latimer,Oklahoma,40077,2457,35,2492
8/21/2022,Kiowa,Oklahoma,40075,2117,55,2172
8/21/2022,Kingfisher,Oklahoma,40073,4455,71,4526
8/21/2022,Kay,Oklahoma,40071,13598,220,13818
8/21/2022,Johnston,Oklahoma,40069,3359,56,3415
8/21/2022,Jefferson,Oklahoma,40067,1431,26,1457
8/21/2022,Jackson,Oklahoma,40065,7259,108,7367
8/21/2022,Hughes,Oklahoma,40063,2848,63,2911
8/21/2022,Haskell,Oklahoma,40061,3075,42,3117
8/21/2022,Harper,Oklahoma,40059,771,12,783
8/21/2022,Harmon,Oklahoma,40057,645,12,657
8/21/2022,Greer,Oklahoma,40055,1390,38,1428
8/21/2022,Grant,Oklahoma,40053,1149,16,1165
8/21/2022,Grady,Oklahoma,40051,15075,251,15326
8/21/2022,Garvin,Oklahoma,40049,7671,149,7820
8/21/2022,Garfield,Oklahoma,40047,16359,300,16659
8/21/2022,Ellis,Oklahoma,40045,886,11,897
8/21/2022,Dewey,Oklahoma,40043,1135,34,1169
8/21/2022,Delaware,Oklahoma,40041,12195,208,12403
8/21/2022,Custer,Oklahoma,40039,8736,172,8908
8/21/2022,Creek,Oklahoma,40037,20014,339,20353
8/21/2022,Craig,Oklahoma,40035,5249,55,5304
8/21/2022,Cotton,Oklahoma,40033,1564,33,1597
8/21/2022,Comanche,Oklahoma,40031,35917,403,36320
8/21/2022,Coal,Oklahoma,40029,1854,24,1878
8/21/2022,Cleveland,Oklahoma,40027,88798,836,89634
8/21/2022,Cimarron,Oklahoma,40025,627,7,634
8/21/2022,Choctaw,Oklahoma,40023,4493,66,4559
8/21/2022,Cherokee,Oklahoma,40021,15840,155,15995
8/21/2022,Carter,Oklahoma,40019,16260,242,16502
8/21/2022,Canadian,Oklahoma,40017,43833,396,44229
8/21/2022,Caddo,Oklahoma,40015,9064,172,9236
8/21/2022,Borden,Texas,48033,111,2,113
8/21/2022,Bryan,Oklahoma,40013,15208,138,15346
8/21/2022,Blaine,Oklahoma,40011,2632,45,2677
8/21/2022,Beckham,Oklahoma,40009,6447,107,6554
8/21/2022,Beaver,Oklahoma,40007,1065,11,1076
8/21/2022,Atoka,Oklahoma,40005,4228,54,4282
8/21/2022,Bosque,Texas,48035,4494,70,4564
8/21/2022,Alfalfa,Oklahoma,40003,1755,16,1771
8/21/2022,Adair,Oklahoma,40001,8845,78,8923
8/21/2022,Wyandot,Ohio,39175,5889,105,5994
8/21/2022,Wood,Ohio,39173,34960,369,35329
8/21/2022,Williams,Ohio,39171,10082,165,10247
8/21/2022,Wayne,Ohio,39169,25585,448,26033
8/21/2022,Washington,Ohio,39167,13785,214,13999
8/21/2022,Warren,Ohio,39165,65239,596,65835
8/21/2022,Morgan,Alabama,1103,40847,525,41372
8/21/2022,Vinton,Ohio,39163,3265,57,3322
8/21/2022,Van Wert,Ohio,39161,7323,150,7473
8/21/2022,Unknown,Ohio,,0,5,5
8/21/2022,Union,Ohio,39159,17772,105,17877
8/21/2022,Tuscarawas,Ohio,39157,22726,514,23240
8/21/2022,Trumbull,Ohio,39155,46917,963,47880
8/21/2022,Summit,Ohio,39153,127883,1747,129630
8/21/2022,Stark,Ohio,39151,88181,1746,89927
8/21/2022,Shelby,Ohio,39149,12105,191,12296
8/21/2022,Seneca,Ohio,39147,13962,235,14197
8/21/2022,Scioto,Ohio,39145,24072,262,24334
8/21/2022,Sandusky,Ohio,39143,15476,244,15720
8/21/2022,Ross,Ohio,39141,22028,309,22337
8/21/2022,Richland,Ohio,39139,35237,521,35758
8/21/2022,Putnam,Ohio,39137,8952,159,9111
8/21/2022,Bowie,Texas,48037,22307,441,22748
8/21/2022,Preble,Ohio,39135,10434,202,10636
8/21/2022,Portage,Ohio,39133,38792,453,39245
8/21/2022,Pike,Ohio,39131,8673,124,8797
8/21/2022,Pickaway,Ohio,39129,19194,233,19427
8/21/2022,Perry,Ohio,39127,9258,129,9387
8/21/2022,Paulding,Ohio,39125,5064,74,5138
8/21/2022,Ottawa,Ohio,39123,9598,144,9742
8/21/2022,Noble,Ohio,39121,3590,59,3649
8/21/2022,Brazoria,Texas,48039,108475,1005,109480
8/21/2022,Muskingum,Ohio,39119,28507,300,28807
8/21/2022,Morrow,Ohio,39117,8589,105,8694
8/21/2022,Morgan,Ohio,39115,3663,61,3724
8/21/2022,Montgomery,Ohio,39113,143886,2056,145942
8/21/2022,Monroe,Ohio,39111,3829,81,3910
8/21/2022,Miami,Ohio,39109,28621,490,29111
8/21/2022,Mercer,Ohio,39107,10345,144,10489
8/21/2022,Meigs,Ohio,39105,5354,92,5446
8/21/2022,Medina,Ohio,39103,45113,518,45631
8/21/2022,Marion,Ohio,39101,22060,274,22334
8/21/2022,Mahoning,Ohio,39099,59837,1114,60951
8/21/2022,Madison,Ohio,39097,10538,139,10677
8/21/2022,Lucas,Ohio,39095,112968,1444,114412
8/21/2022,Montgomery,Alabama,1101,64469,975,65444
8/21/2022,Lorain,Ohio,39093,77414,1000,78414
8/21/2022,Logan,Ohio,39091,11371,174,11545
8/21/2022,Licking,Ohio,39089,47016,485,47501
8/21/2022,Lawrence,Ohio,39087,20764,266,21030
8/21/2022,Lake,Ohio,39085,54881,749,55630
8/21/2022,Knox,Ohio,39083,14927,234,15161
8/21/2022,Jefferson,Ohio,39081,16696,328,17024
8/21/2022,Brazos,Texas,48041,68219,424,68643
8/21/2022,Monroe,Alabama,1099,5987,81,6068
8/21/2022,Jackson,Ohio,39079,10321,142,10463
8/21/2022,Huron,Ohio,39077,16080,225,16305
8/21/2022,Holmes,Ohio,39075,5405,185,5590
8/21/2022,Hocking,Ohio,39073,7484,125,7609
8/21/2022,Brewster,Texas,48043,1210,32,1242
8/21/2022,Highland,Ohio,39071,11938,185,12123
8/21/2022,Henry,Ohio,39069,7040,108,7148
8/21/2022,Harrison,Ohio,39067,3593,74,3667
8/21/2022,Hardin,Ohio,39065,7755,162,7917
8/21/2022,Hancock,Ohio,39063,18867,278,19145
8/21/2022,Briscoe,Texas,48045,498,8,506
8/21/2022,Hamilton,Ohio,39061,213876,2110,215986
8/21/2022,Brooks,Texas,48047,1876,52,1928
8/21/2022,Guernsey,Ohio,39059,11962,157,12119
8/21/2022,Greene,Ohio,39057,43079,520,43599
8/21/2022,Geauga,Ohio,39055,18028,271,18299
8/21/2022,Gallia,Ohio,39053,8975,130,9105
8/21/2022,Fulton,Ohio,39051,11280,180,11460
8/21/2022,Franklin,Ohio,39049,330677,2666,333343
8/21/2022,Fayette,Ohio,39047,8549,127,8676
8/21/2022,Fairfield,Ohio,39045,42964,437,43401
8/21/2022,Brown,Texas,48049,13267,230,13497
8/21/2022,Erie,Ohio,39043,22028,271,22299
8/21/2022,Delaware,Ohio,39041,50875,276,51151
8/21/2022,Defiance,Ohio,39039,11129,169,11298
8/21/2022,Burleson,Texas,48051,5521,67,5588
8/21/2022,Burnet,Texas,48053,12418,173,12591
8/21/2022,Darke,Ohio,39037,13652,242,13894
8/21/2022,Cuyahoga,Ohio,39035,308799,3888,312687
8/21/2022,Crawford,Ohio,39033,12643,219,12862
8/21/2022,Coshocton,Ohio,39031,8969,163,9132
8/21/2022,Columbiana,Ohio,39029,26811,490,27301
8/21/2022,Clinton,Ohio,39027,11431,172,11603
8/21/2022,Clermont,Ohio,39025,58046,567,58613
8/21/2022,Clark,Ohio,39023,38945,593,39538
8/21/2022,Champaign,Ohio,39021,9690,150,9840
8/21/2022,Carroll,Ohio,39019,5746,129,5875
8/21/2022,Butler,Ohio,39017,103737,1183,104920
8/21/2022,Brown,Ohio,39015,12439,186,12625
8/21/2022,Belmont,Ohio,39013,17348,320,17668
8/21/2022,Auglaize,Ohio,39011,12682,190,12872
8/21/2022,Athens,Ohio,39009,17110,149,17259
8/21/2022,Ashtabula,Ohio,39007,22563,439,23002
8/21/2022,Caldwell,Texas,48055,16389,182,16571
8/21/2022,Ashland,Ohio,39005,13317,221,13538
8/21/2022,Allen,Ohio,39003,29963,481,30444
8/21/2022,Adams,Ohio,39001,7893,153,8046
8/21/2022,Calhoun,Texas,48057,6442,52,6494
8/21/2022,Tinian,Northern Mariana Islands,69120,377,1,378
8/21/2022,Saipan,Northern Mariana Islands,69110,12158,38,12196
8/21/2022,Rota,Northern Mariana Islands,69100,418,0,418
8/21/2022,Williams,North Dakota,38105,11351,68,11419
8/21/2022,Wells,North Dakota,38103,1113,12,1125
8/21/2022,Ward,North Dakota,38101,22349,251,22600
8/21/2022,Callahan,Texas,48059,3210,73,3283
8/21/2022,Walsh,North Dakota,38099,3719,34,3753
8/21/2022,Unknown,North Dakota,,0,144,144
8/21/2022,Traill,North Dakota,38097,2298,26,2324
8/21/2022,Towner,North Dakota,38095,695,12,707
8/21/2022,Stutsman,North Dakota,38093,7658,97,7755
8/21/2022,Steele,North Dakota,38091,402,2,404
8/21/2022,Stark,North Dakota,38089,12579,86,12665
8/21/2022,Slope,North Dakota,38087,67,0,67
8/21/2022,Cameron,Texas,48061,121168,2067,123235
8/21/2022,Sioux,North Dakota,38085,1459,19,1478
8/21/2022,Sheridan,North Dakota,38083,314,7,321
8/21/2022,Sargent,North Dakota,38081,1143,9,1152
8/21/2022,Rolette,North Dakota,38079,7003,43,7046
8/21/2022,Richland,North Dakota,38077,4398,23,4421
8/21/2022,Camp,Texas,48063,3188,76,3264
8/21/2022,Renville,North Dakota,38075,596,15,611
8/21/2022,Ransom,North Dakota,38073,1671,28,1699
8/21/2022,Ramsey,North Dakota,38071,3941,57,3998
8/21/2022,Pierce,North Dakota,38069,1134,32,1166
8/21/2022,Pembina,North Dakota,38067,2165,16,2181
8/21/2022,Oliver,North Dakota,38065,347,5,352
8/21/2022,Carson,Texas,48065,1635,37,1672
8/21/2022,Nelson,North Dakota,38063,835,18,853
8/21/2022,Mountrail,North Dakota,38061,3550,37,3587
8/21/2022,Morton,North Dakota,38059,12128,142,12270
8/21/2022,Mercer,North Dakota,38057,2766,24,2790
8/21/2022,McLean,North Dakota,38055,2941,49,2990
8/21/2022,McKenzie,North Dakota,38053,3449,25,3474
8/21/2022,McIntosh,North Dakota,38051,753,9,762
8/21/2022,McHenry,North Dakota,38049,1442,31,1473
8/21/2022,Mobile,Alabama,1097,125058,1698,126756
8/21/2022,Giles,Virginia,51071,4642,50,4692
8/21/2022,Logan,North Dakota,38047,466,12,478
8/21/2022,LaMoure,North Dakota,38045,1084,20,1104
8/21/2022,Kidder,North Dakota,38043,549,13,562
8/21/2022,Hettinger,North Dakota,38041,868,8,876
8/21/2022,Griggs,North Dakota,38039,635,2,637
8/21/2022,Grant,North Dakota,38037,498,11,509
8/21/2022,Cass,Texas,48067,7990,198,8188
8/21/2022,Grand Forks,North Dakota,38035,24453,125,24578
8/21/2022,Golden Valley,North Dakota,38033,491,4,495
8/21/2022,Foster,North Dakota,38031,1057,23,1080
8/21/2022,Castro,Texas,48069,2513,48,2561
8/21/2022,Emmons,North Dakota,38029,767,18,785
8/21/2022,Eddy,North Dakota,38027,834,6,840
8/21/2022,Dunn,North Dakota,38025,1108,8,1116
8/21/2022,Divide,North Dakota,38023,526,4,530
8/21/2022,Dickey,North Dakota,38021,1645,39,1684
8/21/2022,Cavalier,North Dakota,38019,904,7,911
8/21/2022,Cass,North Dakota,38017,65317,333,65650
8/21/2022,Burleigh,North Dakota,38015,37842,303,38145
8/21/2022,Burke,North Dakota,38013,458,3,461
8/21/2022,Bowman,North Dakota,38011,878,9,887
8/21/2022,Bottineau,North Dakota,38009,1741,26,1767
8/21/2022,Billings,North Dakota,38007,166,1,167
8/21/2022,Benson,North Dakota,38005,2135,23,2158
8/21/2022,Barnes,North Dakota,38003,3233,47,3280
8/21/2022,Adams,North Dakota,38001,633,10,643
8/21/2022,Chambers,Texas,48071,13231,113,13344
8/21/2022,Yancey,North Carolina,37199,5895,60,5955
8/21/2022,Yadkin,North Carolina,37197,12717,123,12840
8/21/2022,Wilson,North Carolina,37195,24692,329,25021
8/21/2022,Wilkes,North Carolina,37193,19856,279,20135
8/21/2022,Wayne,North Carolina,37191,36499,417,36916
8/21/2022,Watauga,North Carolina,37189,13229,72,13301
8/21/2022,Cherokee,Texas,48073,8811,256,9067
8/21/2022,Washington,North Carolina,37187,3435,52,3487
8/21/2022,Warren,North Carolina,37185,5066,47,5113
8/21/2022,Wake,North Carolina,37183,354785,1190,355975
8/21/2022,Vance,North Carolina,37181,13877,126,14003
8/21/2022,Union,North Carolina,37179,70720,507,71227
8/21/2022,Childress,Texas,48075,2786,34,2820
8/21/2022,Tyrrell,North Carolina,37177,1094,9,1103
8/21/2022,Transylvania,North Carolina,37175,7087,79,7166
8/21/2022,Swain,North Carolina,37173,4297,49,4346
8/21/2022,Surry,North Carolina,37171,24330,367,24697
8/21/2022,Stokes,North Carolina,37169,12893,187,13080
8/21/2022,Clay,Texas,48077,2318,38,2356
8/21/2022,Gloucester,Virginia,51073,8370,107,8477
8/21/2022,Stanly,North Carolina,37167,21427,275,21702
8/21/2022,Scotland,North Carolina,37165,11442,136,11578
8/21/2022,Sampson,North Carolina,37163,21101,189,21290
8/21/2022,Rutherford,North Carolina,37161,19369,409,19778
8/21/2022,Rowan,North Carolina,37159,46201,604,46805
8/21/2022,Rockingham,North Carolina,37157,24533,304,24837
8/21/2022,Robeson,North Carolina,37155,46243,556,46799
8/21/2022,Cochran,Texas,48079,941,23,964
8/21/2022,Richmond,North Carolina,37153,14692,195,14887
8/21/2022,Randolph,North Carolina,37151,39404,466,39870
8/21/2022,Polk,North Carolina,37149,4385,68,4453
8/21/2022,Pitt,North Carolina,37147,60225,259,60484
8/21/2022,Person,North Carolina,37145,10931,111,11042
8/21/2022,Perquimans,North Carolina,37143,3131,25,3156
8/21/2022,Pender,North Carolina,37141,17070,134,17204
8/21/2022,Pasquotank,North Carolina,37139,9528,129,9657
8/21/2022,Pamlico,North Carolina,37137,3105,32,3137
8/21/2022,Orange,North Carolina,37135,34249,142,34391
8/21/2022,Coke,Texas,48081,968,20,988
8/21/2022,Onslow,North Carolina,37133,59480,399,59879
8/21/2022,Northampton,North Carolina,37131,5103,88,5191
8/21/2022,New Hanover,North Carolina,37129,58347,409,58756
8/21/2022,Nash,North Carolina,37127,29468,329,29797
8/21/2022,Coleman,Texas,48083,1813,73,1886
8/21/2022,Moore,North Carolina,37125,27726,335,28061
8/21/2022,Montgomery,North Carolina,37123,7997,135,8132
8/21/2022,Mitchell,North Carolina,37121,4166,39,4205
8/21/2022,Collin,Texas,48085,247925,1536,249461
8/21/2022,Mecklenburg,North Carolina,37119,328313,1698,330011
8/21/2022,Collingsworth,Texas,48087,792,16,808
8/21/2022,McDowell,North Carolina,37111,15424,178,15602
8/21/2022,Martin,North Carolina,37117,6991,95,7086
8/21/2022,Madison,North Carolina,37115,5753,82,5835
8/21/2022,Macon,North Carolina,37113,8885,123,9008
8/21/2022,Lincoln,North Carolina,37109,27138,185,27323
8/21/2022,Colorado,Texas,48089,4137,67,4204
8/21/2022,Lenoir,North Carolina,37107,17973,235,18208
8/21/2022,Lee,North Carolina,37105,18040,158,18198
8/21/2022,Jones,North Carolina,37103,2547,41,2588
8/21/2022,Johnston,North Carolina,37101,67664,464,68128
8/21/2022,Jackson,North Carolina,37099,10854,101,10955
8/21/2022,Iredell,North Carolina,37097,54754,487,55241
8/21/2022,Hyde,North Carolina,37095,1533,14,1547
8/21/2022,Hoke,North Carolina,37093,17274,125,17399
8/21/2022,Hertford,North Carolina,37091,5587,90,5677
8/21/2022,Henderson,North Carolina,37089,28684,333,29017
8/21/2022,Haywood,North Carolina,37087,14985,229,15214
8/21/2022,Harnett,North Carolina,37085,38042,352,38394
8/21/2022,Halifax,North Carolina,37083,16224,190,16414
8/21/2022,Guilford,North Carolina,37081,139139,1276,140415
8/21/2022,Greene,North Carolina,37079,6500,72,6572
8/21/2022,Granville,North Carolina,37077,17024,118,17142
8/21/2022,Graham,North Carolina,37075,2550,31,2581
8/21/2022,Goochland,Virginia,51075,4818,57,4875
8/21/2022,Gates,North Carolina,37073,2153,20,2173
8/21/2022,Gaston,North Carolina,37071,73397,888,74285
8/21/2022,Marshall,Alabama,1095,29582,399,29981
8/21/2022,Franklin,North Carolina,37069,23743,83,23826
8/21/2022,Forsyth,North Carolina,37067,108364,861,109225
8/21/2022,Edgecombe,North Carolina,37065,15614,158,15772
8/21/2022,Durham,North Carolina,37063,90793,349,91142
8/21/2022,Duplin,North Carolina,37061,18865,251,19116
8/21/2022,Davie,North Carolina,37059,12951,112,13063
8/21/2022,Davidson,North Carolina,37057,48773,446,49219
8/21/2022,Dare,North Carolina,37055,8899,28,8927
8/21/2022,Currituck,North Carolina,37053,5663,38,5701
8/21/2022,Cumberland,North Carolina,37051,101640,675,102315
8/21/2022,Craven,North Carolina,37049,28573,220,28793
8/21/2022,Columbus,North Carolina,37047,17510,276,17786
8/21/2022,Cleveland,North Carolina,37045,33002,410,33412
8/21/2022,Comal,Texas,48091,39478,565,40043
8/21/2022,Clay,North Carolina,37043,2997,47,3044
8/21/2022,Chowan,North Carolina,37041,4661,62,4723
8/21/2022,Cherokee,North Carolina,37039,7905,127,8032
8/21/2022,Chatham,North Carolina,37037,15573,121,15694
8/21/2022,Catawba,North Carolina,37035,53686,622,54308
8/21/2022,Caswell,North Carolina,37033,5996,53,6049
8/21/2022,Carteret,North Carolina,37031,16624,139,16763
8/21/2022,Camden,North Carolina,37029,1990,9,1999
8/21/2022,Caldwell,North Carolina,37027,25379,316,25695
8/21/2022,Cabarrus,North Carolina,37025,64270,515,64785
8/21/2022,Burke,North Carolina,37023,27804,341,28145
8/21/2022,Buncombe,North Carolina,37021,62794,632,63426
8/21/2022,Brunswick,North Carolina,37019,35913,343,36256
8/21/2022,Bladen,North Carolina,37017,10628,134,10762
8/21/2022,Bertie,North Carolina,37015,4840,72,4912
8/21/2022,Winchester city,Virginia,51840,7195,82,7277
8/21/2022,Comanche,Texas,48093,3855,78,3933
8/21/2022,Marion,Alabama,1093,9034,153,9187
8/21/2022,Marengo,Alabama,1091,5691,109,5800
8/21/2022,Madison,Alabama,1089,103134,993,104127
8/21/2022,Beaufort,North Carolina,37013,14426,178,14604
8/21/2022,Avery,North Carolina,37011,5098,45,5143
8/21/2022,Ashe,North Carolina,37009,6839,85,6924
8/21/2022,Anson,North Carolina,37007,7418,101,7519
8/21/2022,Alleghany,North Carolina,37005,3242,18,3260
8/21/2022,Alexander,North Carolina,37003,11425,145,11570
8/21/2022,Alamance,North Carolina,37001,53843,512,54355
8/21/2022,Yates,New York,36123,3958,40,3998
8/21/2022,Wyoming,New York,36121,9229,86,9315
8/21/2022,Westchester,New York,36119,297978,2789,300767
8/21/2022,Wayne,New York,36117,19712,190,19902
8/21/2022,Washington,New York,36115,14084,125,14209
8/21/2022,Warren,New York,36113,16633,134,16767
8/21/2022,Ulster,New York,36111,37801,381,38182
8/21/2022,Tompkins,New York,36109,23750,90,23840
8/21/2022,Tioga,New York,36107,12551,88,12639
8/21/2022,Sullivan,New York,36105,21493,134,21627
8/21/2022,Suffolk,New York,36103,498989,4543,503532
8/21/2022,St. Lawrence,New York,36089,23980,203,24183
8/21/2022,Steuben,New York,36101,22863,259,23122
8/21/2022,Concho,Texas,48095,1202,11,1213
8/21/2022,Seneca,New York,36099,6804,94,6898
8/21/2022,Cooke,Texas,48097,7980,136,8116
8/21/2022,Schuyler,New York,36097,3983,28,4011
8/21/2022,Schoharie,New York,36095,5857,36,5893
8/21/2022,Schenectady,New York,36093,39251,327,39578
8/21/2022,Coryell,Texas,48099,19369,217,19586
8/21/2022,Saratoga,New York,36091,55308,355,55663
8/21/2022,Macon,Alabama,1087,4552,86,4638
8/21/2022,Lowndes,Alabama,1085,2954,80,3034
8/21/2022,Limestone,Alabama,1083,28206,299,28505
8/21/2022,Rockland,New York,36087,106107,921,107028
8/21/2022,Rensselaer,New York,36083,37620,277,37897
8/21/2022,Putnam,New York,36079,27838,128,27966
8/21/2022,Otsego,New York,36077,11901,97,11998
8/21/2022,Oswego,New York,36075,30674,201,30875
8/21/2022,Orleans,New York,36073,9628,120,9748
8/21/2022,Cottle,Texas,48101,351,9,360
8/21/2022,Orange,New York,36071,123180,985,124165
8/21/2022,Ontario,New York,36069,23332,191,23523
8/21/2022,Onondaga,New York,36067,129588,1110,130698
8/21/2022,Oneida,New York,36065,62261,824,63085
8/21/2022,Niagara,New York,36063,54764,599,55363
8/21/2022,New York City,New York,,2786515,41416,2827931
8/21/2022,Nassau,New York,36059,483802,3986,487788
8/21/2022,Crane,Texas,48103,1402,24,1426
8/21/2022,Montgomery,New York,36057,13528,216,13744
8/21/2022,Monroe,New York,36055,175033,1686,176719
8/21/2022,Madison,New York,36053,15190,132,15322
8/21/2022,Livingston,New York,36051,13105,125,13230
8/21/2022,Lewis,New York,36049,6735,51,6786
8/21/2022,Jefferson,New York,36045,23458,143,23601
8/21/2022,Herkimer,New York,36043,15872,198,16070
8/21/2022,Hamilton,New York,36041,986,5,991
8/21/2022,Greene,New York,36039,9884,137,10021
8/21/2022,Genesee,New York,36037,15160,198,15358
8/21/2022,Fulton,New York,36035,14670,174,14844
8/21/2022,Crockett,Texas,48105,1223,20,1243
8/21/2022,Franklin,New York,36033,10827,48,10875
8/21/2022,Essex,New York,36031,6809,65,6874
8/21/2022,Erie,New York,36029,245135,2728,247863
8/21/2022,Dutchess,New York,36027,74897,687,75584
8/21/2022,Delaware,New York,36025,9097,82,9179
8/21/2022,Cortland,New York,36023,12000,127,12127
8/21/2022,Columbia,New York,36021,12132,153,12285
8/21/2022,Clinton,New York,36019,19950,98,20048
8/21/2022,Chenango,New York,36017,10567,125,10692
8/21/2022,Crosby,Texas,48107,2049,45,2094
8/21/2022,Lee,Alabama,1081,42678,347,43025
8/21/2022,Chemung,New York,36015,24014,240,24254
8/21/2022,Chautauqua,New York,36013,26738,311,27049
8/21/2022,Cayuga,New York,36011,18326,163,18489
8/21/2022,Cattaraugus,New York,36009,17421,230,17651
8/21/2022,Broome,New York,36007,52508,539,53047
8/21/2022,Allegany,New York,36003,9830,159,9989
8/21/2022,Albany,New York,36001,70646,553,71199
8/21/2022,Valencia,New Mexico,35061,22124,294,22418
8/21/2022,Culberson,Texas,48109,525,14,539
8/21/2022,Unknown,New Mexico,,287,0,287
8/21/2022,Dallam,Texas,48111,2271,43,2314
8/21/2022,Dallas,Texas,48113,639060,6859,645919
8/21/2022,Union,New Mexico,35059,1074,17,1091
8/21/2022,Torrance,New Mexico,35057,3462,59,3521
8/21/2022,Taos,New Mexico,35055,6404,97,6501
8/21/2022,Socorro,New Mexico,35053,4306,94,4400
8/21/2022,Sierra,New Mexico,35051,2320,83,2403
8/21/2022,Dawson,Texas,48115,3203,97,3300
8/21/2022,Santa Fe,New Mexico,35049,36294,336,36630
8/21/2022,San Miguel,New Mexico,35047,6887,73,6960
8/21/2022,San Juan,New Mexico,35045,46459,819,47278
8/21/2022,Sandoval,New Mexico,35043,40270,471,40741
8/21/2022,Roosevelt,New Mexico,35041,5641,107,5748
8/21/2022,Rio Arriba,New Mexico,35039,11780,149,11929
8/21/2022,Quay,New Mexico,35037,2307,67,2374
8/21/2022,Otero,New Mexico,35035,17219,205,17424
8/21/2022,Mora,New Mexico,35033,918,20,938
8/21/2022,McKinley,New Mexico,35031,29579,614,30193
8/21/2022,Luna,New Mexico,35029,7578,140,7718
8/21/2022,Los Alamos,New Mexico,35028,4061,21,4082
8/21/2022,Lincoln,New Mexico,35027,6053,69,6122
8/21/2022,Deaf Smith,Texas,48117,5290,115,5405
8/21/2022,Lea,New Mexico,35025,22106,385,22491
8/21/2022,Hidalgo,New Mexico,35023,1212,16,1228
8/21/2022,Lawrence,Alabama,1079,8448,168,8616
8/21/2022,Lauderdale,Alabama,1077,27045,404,27449
8/21/2022,Lamar,Alabama,1075,4201,66,4267
8/21/2022,Harding,New Mexico,35021,93,4,97
8/21/2022,Guadalupe,New Mexico,35019,1592,17,1609
8/21/2022,Grant,New Mexico,35017,8393,105,8498
8/21/2022,Eddy,New Mexico,35015,18331,306,18637
8/21/2022,Do�a Ana,New Mexico,35013,71829,867,72696
8/21/2022,De Baca,New Mexico,35011,640,6,646
8/21/2022,Curry,New Mexico,35009,14166,223,14389
8/21/2022,Delta,Texas,48119,1926,27,1953
8/21/2022,Colfax,New Mexico,35007,2871,68,2939
8/21/2022,Cibola,New Mexico,35006,9217,202,9419
8/21/2022,Chaves,New Mexico,35005,23510,351,23861
8/21/2022,Catron,New Mexico,35003,476,22,498
8/21/2022,Bernalillo,New Mexico,35001,176031,2042,178073
8/21/2022,Warren,New Jersey,34041,27851,350,28201
8/21/2022,Unknown,New Jersey,,2967,0,2967
8/21/2022,Union,New Jersey,34039,171893,2419,174312
8/21/2022,Sussex,New Jersey,34037,39700,507,40207
8/21/2022,Somerset,New Jersey,34035,84680,995,85675
8/21/2022,Salem,New Jersey,34033,16269,256,16525
8/21/2022,Passaic,New Jersey,34031,168928,2374,171302
8/21/2022,Ocean,New Jersey,34029,188644,3086,191730
8/21/2022,Morris,New Jersey,34027,145310,1602,146912
8/21/2022,Monmouth,New Jersey,34025,196108,2264,198372
8/21/2022,Middlesex,New Jersey,34023,238552,2925,241477
8/21/2022,Mercer,New Jersey,34021,95466,1295,96761
8/21/2022,Hunterdon,New Jersey,34019,29963,284,30247
8/21/2022,Hudson,New Jersey,34017,208488,2766,211254
8/21/2022,Gloucester,New Jersey,34015,80993,995,81988
8/21/2022,Essex,New Jersey,34013,255456,3662,259118
8/21/2022,Cumberland,New Jersey,34011,45557,627,46184
8/21/2022,Cape May,New Jersey,34009,26418,318,26736
8/21/2022,Denton,Texas,48121,204352,1385,205737
8/21/2022,DeWitt,Texas,48123,6945,101,7046
8/21/2022,Camden,New Jersey,34007,148236,1877,150113
8/21/2022,Dickens,Texas,48125,488,16,504
8/21/2022,Burlington,New Jersey,34005,123105,1279,124384
8/21/2022,Bergen,New Jersey,34003,279188,3535,282723
8/21/2022,Atlantic,New Jersey,34001,80443,1041,81484
8/21/2022,Unknown,New Hampshire,,2442,6,2448
8/21/2022,Sullivan,New Hampshire,33019,10597,72,10669
8/21/2022,Jefferson,Alabama,1073,211376,2409,213785
8/21/2022,Strafford,New Hampshire,33017,33737,224,33961
8/21/2022,Rockingham,New Hampshire,33015,76847,578,77425
8/21/2022,Jackson,Alabama,1071,16373,246,16619
8/21/2022,Dimmit,Texas,48127,6036,51,6087
8/21/2022,Merrimack,New Hampshire,33013,36154,244,36398
8/21/2022,Hillsborough,New Hampshire,33011,109930,949,110879
8/21/2022,Grafton,New Hampshire,33009,21220,78,21298
8/21/2022,Coos,New Hampshire,33007,7730,120,7850
8/21/2022,Cheshire,New Hampshire,33005,17146,121,17267
8/21/2022,Carroll,New Hampshire,33003,11042,66,11108
8/21/2022,Belknap,New Hampshire,33001,15615,189,15804
8/21/2022,Donley,Texas,48129,1212,26,1238
8/21/2022,White Pine,Nevada,32033,1712,22,1734
8/21/2022,Washoe,Nevada,32031,120184,1263,121447
8/21/2022,Unknown,Nevada,,7846,4,7850
8/21/2022,Storey,Nevada,32029,166,14,180
8/21/2022,Pershing,Nevada,32027,2278,31,2309
8/21/2022,Nye,Nevada,32023,8431,278,8709
8/21/2022,Mineral,Nevada,32021,1409,18,1427
8/21/2022,Lyon,Nevada,32019,11407,179,11586
8/21/2022,Duval,Texas,48131,3924,70,3994
8/21/2022,Lincoln,Nevada,32017,560,8,568
8/21/2022,Lander,Nevada,32015,1247,21,1268
8/21/2022,Humboldt,Nevada,32013,2678,58,2736
8/21/2022,Eureka,Nevada,32011,174,2,176
8/21/2022,Esmeralda,Nevada,32009,119,4,123
8/21/2022,Elko,Nevada,32007,12515,140,12655
8/21/2022,Douglas,Nevada,32005,8298,95,8393
8/21/2022,Clark,Nevada,32003,634733,8878,643611
8/21/2022,Churchill,Nevada,32001,7252,117,7369
8/21/2022,Carson City,Nevada,32510,16452,225,16677
8/21/2022,York,Nebraska,31185,4317,23,4340
8/21/2022,Wheeler,Nebraska,31183,128,2,130
8/21/2022,Webster,Nebraska,31181,749,11,760
8/21/2022,Wayne,Nebraska,31179,1953,11,1964
8/21/2022,Washington,Nebraska,31177,5011,45,5056
8/21/2022,Valley,Nebraska,31175,787,6,793
8/21/2022,Unknown,Nebraska,,7288,545,7833
8/21/2022,Thurston,Nebraska,31173,1904,23,1927
8/21/2022,Thomas,Nebraska,31171,105,1,106
8/21/2022,Thayer,Nebraska,31169,1186,8,1194
8/21/2022,Stanton,Nebraska,31167,691,11,702
8/21/2022,Sioux,Nebraska,31165,78,1,79
8/21/2022,Sherman,Nebraska,31163,635,4,639
8/21/2022,Sheridan,Nebraska,31161,1044,23,1067
8/21/2022,Houston,Alabama,1069,29113,517,29630
8/21/2022,Henry,Alabama,1067,5211,78,5289
8/21/2022,Seward,Nebraska,31159,3542,43,3585
8/21/2022,Scotts Bluff,Nebraska,31157,10217,102,10319
8/21/2022,Saunders,Nebraska,31155,5298,30,5328
8/21/2022,Sarpy,Nebraska,31153,54440,304,54744
8/21/2022,Saline,Nebraska,31151,4014,12,4026
8/21/2022,Rock,Nebraska,31149,186,2,188
8/21/2022,Eastland,Texas,48133,3055,115,3170
8/21/2022,Ector,Texas,48135,40536,713,41249
8/21/2022,Richardson,Nebraska,31147,1992,24,2016
8/21/2022,Red Willow,Nebraska,31145,2471,21,2492
8/21/2022,Polk,Nebraska,31143,1251,18,1269
8/21/2022,Platte,Nebraska,31141,9307,75,9382
8/21/2022,Pierce,Nebraska,31139,1345,21,1366
8/21/2022,Phelps,Nebraska,31137,2523,14,2537
8/21/2022,Perkins,Nebraska,31135,552,12,564
8/21/2022,Pawnee,Nebraska,31133,466,4,470
8/21/2022,Otoe,Nebraska,31131,3637,21,3658
8/21/2022,Nuckolls,Nebraska,31129,1020,13,1033
8/21/2022,Nemaha,Nebraska,31127,1445,20,1465
8/21/2022,Nance,Nebraska,31125,815,13,828
8/21/2022,Edwards,Texas,48137,528,11,539
8/21/2022,Ellis,Texas,48139,53603,592,54195
8/21/2022,Hale,Alabama,1065,5251,109,5360
8/21/2022,El Paso,Texas,48141,234578,3781,238359
8/21/2022,Greene,Alabama,1063,2079,51,2130
8/21/2022,Geneva,Alabama,1061,7218,165,7383
8/21/2022,Franklin,Alabama,1059,10601,140,10741
8/21/2022,Grayson,Virginia,51077,4623,83,4706
8/21/2022,Fayette,Alabama,1057,5343,97,5440
8/21/2022,Greene,Virginia,51079,4574,64,4638
8/21/2022,Morrill,Nebraska,31123,1207,21,1228
8/21/2022,Erath,Texas,48143,9249,125,9374
8/21/2022,Merrick,Nebraska,31121,1859,17,1876
8/21/2022,McPherson,Nebraska,31117,72,1,73
8/21/2022,Madison,Nebraska,31119,10445,70,10515
8/21/2022,Loup,Nebraska,31115,85,0,85
8/21/2022,Logan,Nebraska,31113,154,0,154
8/21/2022,Lincoln,Nebraska,31111,9582,121,9703
8/21/2022,Lancaster,Nebraska,31109,86557,450,87007
8/21/2022,Knox,Nebraska,31107,1778,13,1791
8/21/2022,Kimball,Nebraska,31105,789,9,798
8/21/2022,Keya Paha,Nebraska,31103,124,0,124
8/21/2022,Falls,Texas,48145,4115,68,4183
8/21/2022,Keith,Nebraska,31101,1663,21,1684
8/21/2022,Kearney,Nebraska,31099,1306,9,1315
8/21/2022,Fannin,Texas,48147,7465,185,7650
8/21/2022,Johnson,Nebraska,31097,892,10,902
8/21/2022,Jefferson,Nebraska,31095,1280,7,1287
8/21/2022,Fayette,Texas,48149,5188,113,5301
8/21/2022,Howard,Nebraska,31093,1248,16,1264
8/21/2022,Hooker,Nebraska,31091,117,5,122
8/21/2022,Holt,Nebraska,31089,2342,20,2362
8/21/2022,Hitchcock,Nebraska,31087,584,8,592
8/21/2022,Hayes,Nebraska,31085,101,0,101
8/21/2022,Harlan,Nebraska,31083,374,3,377
8/21/2022,Hamilton,Nebraska,31081,2512,26,2538
8/21/2022,Hall,Nebraska,31079,17627,147,17774
8/21/2022,Greeley,Nebraska,31077,436,2,438
8/21/2022,Grant,Nebraska,31075,101,6,107
8/21/2022,Gosper,Nebraska,31073,408,7,415
8/21/2022,Garfield,Nebraska,31071,428,2,430
8/21/2022,Garden,Nebraska,31069,406,1,407
8/21/2022,Gage,Nebraska,31067,3759,45,3804
8/21/2022,Furnas,Nebraska,31065,1199,8,1207
8/21/2022,Frontier,Nebraska,31063,576,3,579
8/21/2022,Franklin,Nebraska,31061,455,13,468
8/21/2022,Fillmore,Nebraska,31059,1214,13,1227
8/21/2022,Dundy,Nebraska,31057,353,6,359
8/21/2022,Douglas,Nebraska,31055,166025,1161,167186
8/21/2022,Fisher,Texas,48151,660,26,686
8/21/2022,Dodge,Nebraska,31053,10873,111,10984
8/21/2022,Floyd,Texas,48153,2142,48,2190
8/21/2022,Etowah,Alabama,1055,30949,660,31609
8/21/2022,Escambia,Alabama,1053,11230,175,11405
8/21/2022,Elmore,Alabama,1051,26707,354,27061
8/21/2022,Lewis,West Virginia,54041,6250,91,6341
8/21/2022,Dixon,Nebraska,31051,1287,11,1298
8/21/2022,Deuel,Nebraska,31049,332,3,335
8/21/2022,Dawson,Nebraska,31047,5560,44,5604
8/21/2022,Dawes,Nebraska,31045,1447,21,1468
8/21/2022,Dakota,Nebraska,31043,7357,82,7439
8/21/2022,Custer,Nebraska,31041,2155,31,2186
8/21/2022,Cuming,Nebraska,31039,1917,15,1932
8/21/2022,Foard,Texas,48155,230,11,241
8/21/2022,Colfax,Nebraska,31037,2810,28,2838
8/21/2022,Clay,Nebraska,31035,1609,25,1634
8/21/2022,Cheyenne,Nebraska,31033,2183,24,2207
8/21/2022,Cherry,Nebraska,31031,591,12,603
8/21/2022,Chase,Nebraska,31029,849,8,857
8/21/2022,Cedar,Nebraska,31027,1575,14,1589
8/21/2022,Cass,Nebraska,31025,6660,46,6706
8/21/2022,Butler,Nebraska,31023,2082,18,2100
8/21/2022,Burt,Nebraska,31021,1408,17,1425
8/21/2022,Fort Bend,Texas,48157,225731,1279,227010
8/21/2022,Buffalo,Nebraska,31019,13035,104,13139
8/21/2022,Brown,Nebraska,31017,585,4,589
8/21/2022,Boyd,Nebraska,31015,432,7,439
8/21/2022,Box Butte,Nebraska,31013,2364,17,2381
8/21/2022,Boone,Nebraska,31011,1132,5,1137
8/21/2022,Blaine,Nebraska,31009,72,3,75
8/21/2022,Banner,Nebraska,31007,92,2,94
8/21/2022,Franklin,Texas,48159,2398,45,2443
8/21/2022,Arthur,Nebraska,31005,33,1,34
8/21/2022,Antelope,Nebraska,31003,1179,14,1193
8/21/2022,Adams,Nebraska,31001,7097,74,7171
8/21/2022,Yellowstone,Montana,30111,46868,571,47439
8/21/2022,Wibaux,Montana,30109,218,8,226
8/21/2022,Wheatland,Montana,30107,418,14,432
8/21/2022,Valley,Montana,30105,1928,38,1966
8/21/2022,Treasure,Montana,30103,142,1,143
8/21/2022,Toole,Montana,30101,1331,25,1356
8/21/2022,Teton,Montana,30099,1415,26,1441
8/21/2022,Sweet Grass,Montana,30097,844,13,857
8/21/2022,Stillwater,Montana,30095,1631,32,1663
8/21/2022,Silver Bow,Montana,30093,9202,135,9337
8/21/2022,Sheridan,Montana,30091,813,12,825
8/21/2022,Sanders,Montana,30089,2299,52,2351
8/21/2022,Rosebud,Montana,30087,2876,61,2937
8/21/2022,DeKalb,Alabama,1049,20360,334,20694
8/21/2022,Dallas,Alabama,1047,9783,251,10034
8/21/2022,Freestone,Texas,48161,4074,85,4159
8/21/2022,Dale,Alabama,1045,14826,236,15062
8/21/2022,Cullman,Alabama,1043,27665,373,28038
8/21/2022,Crenshaw,Alabama,1041,4241,102,4343
8/21/2022,Roosevelt,Montana,30085,3504,75,3579
8/21/2022,Richland,Montana,30083,2794,36,2830
8/21/2022,Ravalli,Montana,30081,7724,166,7890
8/21/2022,Prairie,Montana,30079,281,3,284
8/21/2022,Powell,Montana,30077,2074,30,2104
8/21/2022,Frio,Texas,48163,6376,94,6470
8/21/2022,Powder River,Montana,30075,388,10,398
8/21/2022,Pondera,Montana,30073,1336,9,1345
8/21/2022,Phillips,Montana,30071,1108,29,1137
8/21/2022,Petroleum,Montana,30069,35,1,36
8/21/2022,Park,Montana,30067,4828,36,4864
8/21/2022,Musselshell,Montana,30065,993,31,1024
8/21/2022,Missoula,Montana,30063,31029,216,31245
8/21/2022,Mineral,Montana,30061,1234,17,1251
8/21/2022,Gaines,Texas,48165,2304,83,2387
8/21/2022,Meagher,Montana,30059,506,10,516
8/21/2022,McCone,Montana,30055,415,9,424
8/21/2022,Madison,Montana,30057,2155,23,2178
8/21/2022,Lincoln,Montana,30053,5201,91,5292
8/21/2022,Covington,Alabama,1039,10453,244,10697
8/21/2022,Liberty,Montana,30051,454,4,458
8/21/2022,Lewis and Clark,Montana,30049,20121,193,20314
8/21/2022,Lake,Montana,30047,7439,103,7542
8/21/2022,Judith Basin,Montana,30045,252,1,253
8/21/2022,Jefferson,Montana,30043,2891,25,2916
8/21/2022,Hill,Montana,30041,5008,73,5081
8/21/2022,Granite,Montana,30039,612,10,622
8/21/2022,Golden Valley,Montana,30037,157,5,162
8/21/2022,Glacier,Montana,30035,4333,75,4408
8/21/2022,Garfield,Montana,30033,243,3,246
8/21/2022,Galveston,Texas,48167,111566,871,112437
8/21/2022,Garza,Texas,48169,1360,29,1389
8/21/2022,Gillespie,Texas,48171,5848,111,5959
8/21/2022,Gallatin,Montana,30031,38820,126,38946
8/21/2022,Flathead,Montana,30029,31744,290,32034
8/21/2022,Glasscock,Texas,48173,218,3,221
8/21/2022,Fergus,Montana,30027,2715,58,2773
8/21/2022,Goliad,Texas,48175,1409,32,1441
8/21/2022,Fallon,Montana,30025,708,10,718
8/21/2022,Deer Lodge,Montana,30023,2867,30,2897
8/21/2022,Dawson,Montana,30021,2562,59,2621
8/21/2022,Daniels,Montana,30019,429,9,438
8/21/2022,Custer,Montana,30017,3238,50,3288
8/21/2022,Chouteau,Montana,30015,1117,15,1132
8/21/2022,Cascade,Montana,30013,27426,354,27780
8/21/2022,Carter,Montana,30011,272,5,277
8/21/2022,Carbon,Montana,30009,2259,28,2287
8/21/2022,Broadwater,Montana,30007,1414,21,1435
8/21/2022,Blaine,Montana,30005,2338,33,2371
8/21/2022,Big Horn,Montana,30003,5363,102,5465
8/21/2022,Beaverhead,Montana,30001,2322,30,2352
8/21/2022,Wright,Missouri,29229,4210,92,4302
8/21/2022,Worth,Missouri,29227,448,3,451
8/21/2022,Webster,Missouri,29225,9617,156,9773
8/21/2022,Wayne,Missouri,29223,2624,55,2679
8/21/2022,Washington,Missouri,29221,6541,147,6688
8/21/2022,Warren,Missouri,29219,8989,107,9096
8/21/2022,Vernon,Missouri,29217,5609,111,5720
8/21/2022,Texas,Missouri,29215,5116,107,5223
8/21/2022,Taney,Missouri,29213,14842,239,15081
8/21/2022,Gonzales,Texas,48177,5085,105,5190
8/21/2022,Sullivan,Missouri,29211,1839,24,1863
8/21/2022,Stone,Missouri,29209,6375,124,6499
8/21/2022,Stoddard,Missouri,29207,6646,139,6785
8/21/2022,St. Louis city,Missouri,29510,68055,804,68859
8/21/2022,Gray,Texas,48179,6580,130,6710
8/21/2022,St. Louis,Missouri,29189,262252,3463,265715
8/21/2022,St. Francois,Missouri,29187,20954,304,21258
8/21/2022,Ste. Genevieve,Missouri,29186,4187,39,4226
8/21/2022,St. Clair,Missouri,29185,2343,39,2382
8/21/2022,St. Charles,Missouri,29183,117018,978,117996
8/21/2022,Shelby,Missouri,29205,1831,15,1846
8/21/2022,Shannon,Missouri,29203,1726,41,1767
8/21/2022,Scott,Missouri,29201,12457,164,12621
8/21/2022,Scotland,Missouri,29199,731,18,749
8/21/2022,Schuyler,Missouri,29197,817,27,844
8/21/2022,Saline,Missouri,29195,6761,110,6871
8/21/2022,Ripley,Missouri,29181,2934,63,2997
8/21/2022,Reynolds,Missouri,29179,1264,27,1291
8/21/2022,Ray,Missouri,29177,5661,96,5757
8/21/2022,Grayson,Texas,48181,29421,650,30071
8/21/2022,Randolph,Missouri,29175,6504,108,6612
8/21/2022,Ralls,Missouri,29173,2697,30,2727
8/21/2022,Putnam,Missouri,29171,1105,26,1131
8/21/2022,Pulaski,Missouri,29169,9988,119,10107
8/21/2022,Polk,Missouri,29167,9016,111,9127
8/21/2022,Platte,Missouri,29165,11696,104,11800
8/21/2022,Gregg,Texas,48183,25141,702,25843
8/21/2022,Pike,Missouri,29163,4674,64,4738
8/21/2022,Grimes,Texas,48185,9411,125,9536
8/21/2022,Phelps,Missouri,29161,11437,251,11688
8/21/2022,Pettis,Missouri,29159,13534,174,13708
8/21/2022,Perry,Missouri,29157,5678,46,5724
8/21/2022,Pemiscot,Missouri,29155,3329,82,3411
8/21/2022,Ozark,Missouri,29153,1900,63,1963
8/21/2022,Osage,Missouri,29151,3450,47,3497
8/21/2022,Oregon,Missouri,29149,2184,37,2221
8/21/2022,Nodaway,Missouri,29147,6636,46,6682
8/21/2022,Newton,Missouri,29145,12775,212,12987
8/21/2022,New Madrid,Missouri,29143,5504,87,5591
8/21/2022,Morgan,Missouri,29141,4408,117,4525
8/21/2022,Guadalupe,Texas,48187,42446,406,42852
8/21/2022,Hale,Texas,48189,7356,246,7602
8/21/2022,Montgomery,Missouri,29139,2793,60,2853
8/21/2022,Monroe,Missouri,29137,2349,46,2395
8/21/2022,Moniteau,Missouri,29135,4066,57,4123
8/21/2022,Mississippi,Missouri,29133,3978,59,4037
8/21/2022,Miller,Missouri,29131,6512,125,6637
8/21/2022,Mercer,Missouri,29129,799,14,813
8/21/2022,Coosa,Alabama,1037,3332,59,3391
8/21/2022,McDonald,Missouri,29119,6236,81,6317
8/21/2022,Marion,Missouri,29127,8938,126,9064
8/21/2022,Maries,Missouri,29125,1761,39,1800
8/21/2022,Hall,Texas,48191,1176,24,1200
8/21/2022,Madison,Missouri,29123,3906,59,3965
8/21/2022,Macon,Missouri,29121,3961,63,4024
8/21/2022,Livingston,Missouri,29117,4065,101,4166
8/21/2022,Linn,Missouri,29115,2813,67,2880
8/21/2022,Lincoln,Missouri,29113,16674,146,16820
8/21/2022,Lewis,Missouri,29111,3051,43,3094
8/21/2022,Lawrence,Missouri,29109,8464,173,8637
8/21/2022,Hamilton,Texas,48193,2017,34,2051
8/21/2022,Hansford,Texas,48195,2131,30,2161
8/21/2022,Lafayette,Missouri,29107,8481,138,8619
8/21/2022,Laclede,Missouri,29105,8811,182,8993
8/21/2022,Knox,Missouri,29103,1105,15,1120
8/21/2022,Kansas City,Missouri,,127744,1354,129098
8/21/2022,Joplin,Missouri,,15002,225,15227
8/21/2022,Hardeman,Texas,48197,581,20,601
8/21/2022,Johnson,Missouri,29101,13256,146,13402
8/21/2022,Jefferson,Missouri,29099,60986,672,61658
8/21/2022,Jasper,Missouri,29097,22466,326,22792
8/21/2022,Hardin,Texas,48199,13676,253,13929
8/21/2022,Jackson,Missouri,29095,107114,1245,108359
8/21/2022,Iron,Missouri,29093,2389,46,2435
8/21/2022,Howell,Missouri,29091,10080,223,10303
8/21/2022,Howard,Missouri,29089,2686,30,2716
8/21/2022,Harris,Texas,48201,1183040,11203,1194243
8/21/2022,Conecuh,Alabama,1035,3250,72,3322
8/21/2022,Colbert,Alabama,1033,18654,266,18920
8/21/2022,Harrison,Texas,48203,14576,227,14803
8/21/2022,Greensville,Virginia,51081,3486,41,3527
8/21/2022,Holt,Missouri,29087,1170,30,1200
8/21/2022,Hickory,Missouri,29085,2089,58,2147
8/21/2022,Henry,Missouri,29083,6443,91,6534
8/21/2022,Harrison,Missouri,29081,2128,35,2163
8/21/2022,Grundy,Missouri,29079,2816,69,2885
8/21/2022,Greene,Missouri,29077,78058,1078,79136
8/21/2022,Gentry,Missouri,29075,2376,32,2408
8/21/2022,Gasconade,Missouri,29073,3663,104,3767
8/21/2022,Franklin,Missouri,29071,28387,384,28771
8/21/2022,Hartley,Texas,48205,1412,3,1415
8/21/2022,Dunklin,Missouri,29069,8824,129,8953
8/21/2022,Douglas,Missouri,29067,2806,83,2889
8/21/2022,Dent,Missouri,29065,3583,88,3671
8/21/2022,DeKalb,Missouri,29063,2392,47,2439
8/21/2022,Daviess,Missouri,29061,1886,30,1916
8/21/2022,Dallas,Missouri,29059,4215,76,4291
8/21/2022,Dade,Missouri,29057,1616,43,1659
8/21/2022,Crawford,Missouri,29055,5917,108,6025
8/21/2022,Cooper,Missouri,29053,4411,79,4490
8/21/2022,Cole,Missouri,29051,21892,291,22183
8/21/2022,Clinton,Missouri,29049,5240,123,5363
8/21/2022,Clay,Missouri,29047,30199,376,30575
8/21/2022,Clark,Missouri,29045,1762,40,1802
8/21/2022,Christian,Missouri,29043,22871,269,23140
8/21/2022,Chariton,Missouri,29041,1860,38,1898
8/21/2022,Cedar,Missouri,29039,3335,59,3394
8/21/2022,Cass,Missouri,29037,27692,325,28017
8/21/2022,Carter,Missouri,29035,1600,24,1624
8/21/2022,Carroll,Missouri,29033,2403,45,2448
8/21/2022,Cape Girardeau,Missouri,29031,21087,251,21338
8/21/2022,Camden,Missouri,29029,10111,188,10299
8/21/2022,Callaway,Missouri,29027,13134,134,13268
8/21/2022,Caldwell,Missouri,29025,1888,39,1927
8/21/2022,Butler,Missouri,29023,11132,178,11310
8/21/2022,Buchanan,Missouri,29021,27109,323,27432
8/21/2022,Coffee,Alabama,1031,15470,237,15707
8/21/2022,Cleburne,Alabama,1029,3797,69,3866
8/21/2022,Clay,Alabama,1027,4547,84,4631
8/21/2022,Boone,Missouri,29019,50222,267,50489
8/21/2022,Bollinger,Missouri,29017,2867,44,2911
8/21/2022,Benton,Missouri,29015,4875,109,4984
8/21/2022,Bates,Missouri,29013,3995,98,4093
8/21/2022,Barton,Missouri,29011,3095,53,3148
8/21/2022,Barry,Missouri,29009,7266,146,7412
8/21/2022,Audrain,Missouri,29007,6179,114,6293
8/21/2022,Atchison,Missouri,29005,1560,23,1583
8/21/2022,Haskell,Texas,48207,988,39,1027
8/21/2022,Andrew,Missouri,29003,5197,59,5256
8/21/2022,Hays,Texas,48209,71801,532,72333
8/21/2022,Adair,Missouri,29001,6084,68,6152
8/21/2022,Yazoo,Mississippi,28163,8918,111,9029
8/21/2022,Yalobusha,Mississippi,28161,4487,60,4547
8/21/2022,Hemphill,Texas,48211,1302,7,1309
8/21/2022,Winston,Mississippi,28159,5893,104,5997
8/21/2022,Wilkinson,Mississippi,28157,1892,46,1938
8/21/2022,Webster,Mississippi,28155,3669,73,3742
8/21/2022,Wayne,Mississippi,28153,6458,88,6546
8/21/2022,Washington,Mississippi,28151,11380,205,11585
8/21/2022,Warren,Mississippi,28149,11699,209,11908
8/21/2022,Walthall,Mississippi,28147,4133,81,4214
8/21/2022,Unknown,Mississippi,,6116,29,6145
8/21/2022,Union,Mississippi,28145,10443,126,10569
8/21/2022,Tunica,Mississippi,28143,2805,48,2853
8/21/2022,Tishomingo,Mississippi,28141,6839,122,6961
8/21/2022,Tippah,Mississippi,28139,8078,109,8187
8/21/2022,Tate,Mississippi,28137,8095,147,8242
8/21/2022,Henderson,Texas,48213,16933,429,17362
8/21/2022,Tallahatchie,Mississippi,28135,3492,62,3554
8/21/2022,Sunflower,Mississippi,28133,6164,126,6290
8/21/2022,Stone,Mississippi,28131,6143,74,6217
8/21/2022,Smith,Mississippi,28129,4564,69,4633
8/21/2022,Simpson,Mississippi,28127,7939,154,8093
8/21/2022,Sharkey,Mississippi,28125,1077,27,1104
8/21/2022,Scott,Mississippi,28123,7255,121,7376
8/21/2022,Rankin,Mississippi,28121,42092,501,42593
8/21/2022,Quitman,Mississippi,28119,1717,32,1749
8/21/2022,Prentiss,Mississippi,28117,9092,106,9198
8/21/2022,Pontotoc,Mississippi,28115,11441,154,11595
8/21/2022,Pike,Mississippi,28113,11258,189,11447
8/21/2022,Perry,Mississippi,28111,3419,64,3483
8/21/2022,Pearl River,Mississippi,28109,16643,280,16923
8/21/2022,Panola,Mississippi,28107,11421,173,11594
8/21/2022,Clarke,Alabama,1025,7857,104,7961
8/21/2022,Oktibbeha,Mississippi,28105,12314,167,12481
8/21/2022,Noxubee,Mississippi,28103,3105,48,3153
8/21/2022,Newton,Mississippi,28101,6522,99,6621
8/21/2022,Neshoba,Mississippi,28099,11629,243,11872
8/21/2022,Montgomery,Mississippi,28097,3282,80,3362
8/21/2022,Monroe,Mississippi,28095,12081,223,12304
8/21/2022,Marshall,Mississippi,28093,10825,178,11003
8/21/2022,Marion,Mississippi,28091,7895,138,8033
8/21/2022,Choctaw,Alabama,1023,2155,37,2192
8/21/2022,Madison,Mississippi,28089,28145,337,28482
8/21/2022,Lowndes,Mississippi,28087,19364,243,19607
8/21/2022,Lincoln,Mississippi,28085,9439,160,9599
8/21/2022,Leflore,Mississippi,28083,8088,174,8262
8/21/2022,Lee,Mississippi,28081,30244,311,30555
8/21/2022,Leake,Mississippi,28079,7027,122,7149
8/21/2022,Lawrence,Mississippi,28077,4048,57,4105
8/21/2022,Lauderdale,Mississippi,28075,20268,373,20641
8/21/2022,Lamar,Mississippi,28073,20042,164,20206
8/21/2022,Lafayette,Mississippi,28071,17111,182,17293
8/21/2022,Hidalgo,Texas,48215,239748,3962,243710
8/21/2022,Kemper,Mississippi,28069,2377,51,2428
8/21/2022,Jones,Mississippi,28067,23826,304,24130
8/21/2022,Jefferson Davis,Mississippi,28065,3213,56,3269
8/21/2022,Jefferson,Mississippi,28063,1692,37,1729
8/21/2022,Jasper,Mississippi,28061,5597,76,5673
8/21/2022,Jackson,Mississippi,28059,42022,480,42502
8/21/2022,Itawamba,Mississippi,28057,8200,145,8345
8/21/2022,Hill,Texas,48217,9549,197,9746
8/21/2022,Issaquena,Mississippi,28055,287,9,296
8/21/2022,Humphreys,Mississippi,28053,2176,47,2223
8/21/2022,Holmes,Mississippi,28051,4837,104,4941
8/21/2022,Hinds,Mississippi,28049,61010,812,61822
8/21/2022,Harrison,Mississippi,28047,60690,683,61373
8/21/2022,Hancock,Mississippi,28045,13922,156,14078
8/21/2022,Grenada,Mississippi,28043,5943,133,6076
8/21/2022,Chilton,Alabama,1021,12008,212,12220
8/21/2022,Greene,Mississippi,28041,3570,59,3629
8/21/2022,George,Mississippi,28039,8015,89,8104
8/21/2022,Franklin,Mississippi,28037,2131,38,2169
8/21/2022,Forrest,Mississippi,28035,25090,317,25407
8/21/2022,Hockley,Texas,48219,8419,164,8583
8/21/2022,Hood,Texas,48221,14163,281,14444
8/21/2022,Hopkins,Texas,48223,7838,185,8023
8/21/2022,DeSoto,Mississippi,28033,55623,562,56185
8/21/2022,Covington,Mississippi,28031,7857,117,7974
8/21/2022,Copiah,Mississippi,28029,8295,121,8416
8/21/2022,Coahoma,Mississippi,28027,7217,131,7348
8/21/2022,Clay,Mississippi,28025,5551,99,5650
8/21/2022,Clarke,Mississippi,28023,4513,108,4621
8/21/2022,Claiborne,Mississippi,28021,2398,46,2444
8/21/2022,Choctaw,Mississippi,28019,2593,33,2626
8/21/2022,Chickasaw,Mississippi,28017,6247,97,6344
8/21/2022,Carroll,Mississippi,28015,2841,56,2897
8/21/2022,Calhoun,Mississippi,28013,5007,73,5080
8/21/2022,Bolivar,Mississippi,28011,10316,184,10500
8/21/2022,Benton,Mississippi,28009,2486,49,2535
8/21/2022,Attala,Mississippi,28007,6129,117,6246
8/21/2022,Amite,Mississippi,28005,3575,70,3645
8/21/2022,Alcorn,Mississippi,28003,11470,162,11632
8/21/2022,Houston,Texas,48225,4582,113,4695
8/21/2022,Adams,Mississippi,28001,8121,148,8269
8/21/2022,Yellow Medicine,Minnesota,27173,2794,31,2825
8/21/2022,Wright,Minnesota,27171,39636,312,39948
8/21/2022,Winona,Minnesota,27169,14457,77,14534
8/21/2022,Wilkin,Minnesota,27167,1786,23,1809
8/21/2022,Watonwan,Minnesota,27165,3162,24,3186
8/21/2022,Howard,Texas,48227,7339,189,7528
8/21/2022,Hudspeth,Texas,48229,1123,18,1141
8/21/2022,Washington,Minnesota,27163,75912,511,76423
8/21/2022,Hunt,Texas,48231,17677,366,18043
8/21/2022,Waseca,Minnesota,27161,5984,39,6023
8/21/2022,Wadena,Minnesota,27159,4659,58,4717
8/21/2022,Wabasha,Minnesota,27157,6234,19,6253
8/21/2022,Unknown,Minnesota,,770,349,1119
8/21/2022,Traverse,Minnesota,27155,918,11,929
8/21/2022,Todd,Minnesota,27153,7585,62,7647
8/21/2022,Swift,Minnesota,27151,2472,33,2505
8/21/2022,St. Louis,Minnesota,27137,54476,563,55039
8/21/2022,Stevens,Minnesota,27149,2981,14,2995
8/21/2022,Steele,Minnesota,27147,11212,63,11275
8/21/2022,Stearns,Minnesota,27145,55982,383,56365
8/21/2022,Sibley,Minnesota,27143,3857,27,3884
8/21/2022,Sherburne,Minnesota,27141,29375,186,29561
8/21/2022,Scott,Minnesota,27139,44697,270,44967
8/21/2022,Roseau,Minnesota,27135,4766,46,4812
8/21/2022,Rock,Minnesota,27133,2538,35,2573
8/21/2022,Rice,Minnesota,27131,19439,190,19629
8/21/2022,Renville,Minnesota,27129,4126,58,4184
8/21/2022,Redwood,Minnesota,27127,4276,54,4330
8/21/2022,Cherokee,Alabama,1019,5737,87,5824
8/21/2022,Chambers,Alabama,1017,9706,165,9871
8/21/2022,Hutchinson,Texas,48233,7123,137,7260
8/21/2022,Calhoun,Alabama,1015,35426,640,36066
8/21/2022,Red Lake,Minnesota,27125,988,13,1001
8/21/2022,Ramsey,Minnesota,27123,143928,1404,145332
8/21/2022,Pope,Minnesota,27121,3492,20,3512
8/21/2022,Polk,Minnesota,27119,9684,113,9797
8/21/2022,Pipestone,Minnesota,27117,2140,34,2174
8/21/2022,Pine,Minnesota,27115,7803,68,7871
8/21/2022,Pennington,Minnesota,27113,3932,41,3973
8/21/2022,Otter Tail,Minnesota,27111,14871,174,15045
8/21/2022,Olmsted,Minnesota,27109,48569,195,48764
8/21/2022,Norman,Minnesota,27107,1629,15,1644
8/21/2022,Nobles,Minnesota,27105,7494,61,7555
8/21/2022,Nicollet,Minnesota,27103,9026,71,9097
8/21/2022,Murray,Minnesota,27101,2189,20,2209
8/21/2022,Mower,Minnesota,27099,12838,75,12913
8/21/2022,Morrison,Minnesota,27097,10087,112,10199
8/21/2022,Mille Lacs,Minnesota,27095,7787,119,7906
8/21/2022,Meeker,Minnesota,27093,6503,79,6582
8/21/2022,McLeod,Minnesota,27085,11768,113,11881
8/21/2022,Martin,Minnesota,27091,6109,66,6175
8/21/2022,Marshall,Minnesota,27089,2290,24,2314
8/21/2022,Mahnomen,Minnesota,27087,1947,18,1965
8/21/2022,Irion,Texas,48235,533,3,536
8/21/2022,Lyon,Minnesota,27083,7556,75,7631
8/21/2022,Lincoln,Minnesota,27081,1322,6,1328
8/21/2022,Le Sueur,Minnesota,27079,6974,52,7026
8/21/2022,Lake of the Woods,Minnesota,27077,841,6,847
8/21/2022,Jack,Texas,48237,1608,30,1638
8/21/2022,Lake,Minnesota,27075,2371,31,2402
8/21/2022,Lac qui Parle,Minnesota,27073,1932,29,1961
8/21/2022,Jackson,Texas,48239,3580,59,3639
8/21/2022,Koochiching,Minnesota,27071,3249,40,3289
8/21/2022,Butler,Alabama,1013,5771,129,5900
8/21/2022,Bullock,Alabama,1011,2680,54,2734
8/21/2022,Kittson,Minnesota,27069,1130,29,1159
8/21/2022,Kandiyohi,Minnesota,27067,14453,143,14596
8/21/2022,Kanabec,Minnesota,27065,3913,58,3971
8/21/2022,Jackson,Minnesota,27063,2355,17,2372
8/21/2022,Itasca,Minnesota,27061,12410,152,12562
8/21/2022,Isanti,Minnesota,27059,10921,120,11041
8/21/2022,Jasper,Texas,48241,7364,193,7557
8/21/2022,Jeff Davis,Texas,48243,257,9,266
8/21/2022,Hubbard,Minnesota,27057,5505,60,5565
8/21/2022,Houston,Minnesota,27055,5076,20,5096
8/21/2022,Hennepin,Minnesota,27053,350741,2671,353412
8/21/2022,Grant,Minnesota,27051,1607,12,1619
8/21/2022,Goodhue,Minnesota,27049,14606,146,14752
8/21/2022,Freeborn,Minnesota,27047,9755,78,9833
8/21/2022,Fillmore,Minnesota,27045,5304,27,5331
8/21/2022,Faribault,Minnesota,27043,4134,55,4189
8/21/2022,Douglas,Minnesota,27041,12012,120,12132
8/21/2022,Dodge,Minnesota,27039,6285,22,6307
8/21/2022,Jefferson,Texas,48245,58254,861,59115
8/21/2022,Dakota,Minnesota,27037,125280,807,126087
8/21/2022,Crow Wing,Minnesota,27035,17664,172,17836
8/21/2022,Cottonwood,Minnesota,27033,3470,41,3511
8/21/2022,Cook,Minnesota,27031,692,4,696
8/21/2022,Clearwater,Minnesota,27029,2265,31,2296
8/21/2022,Clay,Minnesota,27027,21700,129,21829
8/21/2022,Jim Hogg,Texas,48247,3269,22,3291
8/21/2022,Chisago,Minnesota,27025,15941,122,16063
8/21/2022,Chippewa,Minnesota,27023,3400,49,3449
8/21/2022,Cass,Minnesota,27021,7793,84,7877
8/21/2022,Jim Wells,Texas,48249,12883,216,13099
8/21/2022,Johnson,Texas,48251,47902,750,48652
8/21/2022,Jones,Texas,48253,4931,93,5024
8/21/2022,Blount,Alabama,1009,16365,251,16616
8/21/2022,Karnes,Texas,48255,6217,72,6289
8/21/2022,Carver,Minnesota,27019,29773,124,29897
8/21/2022,Carlton,Minnesota,27017,10193,104,10297
8/21/2022,Kaufman,Texas,48257,39216,540,39756
8/21/2022,Brown,Minnesota,27015,7210,81,7291
8/21/2022,Blue Earth,Minnesota,27013,19706,105,19811
8/21/2022,Big Stone,Minnesota,27011,1547,9,1556
8/21/2022,Benton,Minnesota,27009,15561,182,15743
8/21/2022,Beltrami,Minnesota,27007,13018,129,13147
8/21/2022,Becker,Minnesota,27005,9640,99,9739
8/21/2022,Anoka,Minnesota,27003,109395,816,110211
8/21/2022,Aitkin,Minnesota,27001,3326,63,3389
8/21/2022,Wexford,Michigan,26165,7841,115,7956
8/21/2022,Wayne,Michigan,26163,467481,8269,475750
8/21/2022,Washtenaw,Michigan,26161,97190,561,97751
8/21/2022,Van Buren,Michigan,26159,18929,288,19217
8/21/2022,Unknown,Michigan,,20382,83,20465
8/21/2022,Tuscola,Michigan,26157,14278,290,14568
8/21/2022,St. Joseph,Michigan,26149,14809,215,15024
8/21/2022,St. Clair,Michigan,26147,44954,854,45808
8/21/2022,Shiawassee,Michigan,26155,19673,233,19906
8/21/2022,Schoolcraft,Michigan,26153,1976,16,1992
8/21/2022,Sanilac,Michigan,26151,9418,205,9623
8/21/2022,Saginaw,Michigan,26145,56255,984,57239
8/21/2022,Roscommon,Michigan,26143,5109,122,5231
8/21/2022,Presque Isle,Michigan,26141,2215,61,2276
8/21/2022,Ottawa,Michigan,26139,81987,823,82810
8/21/2022,Otsego,Michigan,26137,6234,104,6338
8/21/2022,Oscoda,Michigan,26135,1548,58,1606
8/21/2022,Osceola,Michigan,26133,5494,86,5580
8/21/2022,Ontonagon,Michigan,26131,1158,40,1198
8/21/2022,Ogemaw,Michigan,26129,4624,109,4733
8/21/2022,Oceana,Michigan,26127,7049,93,7142
8/21/2022,Oakland,Michigan,26125,339616,4043,343659
8/21/2022,Newaygo,Michigan,26123,12474,161,12635
8/21/2022,Muskegon,Michigan,26121,46149,667,46816
8/21/2022,Montmorency,Michigan,26119,1832,49,1881
8/21/2022,Montcalm,Michigan,26117,18433,224,18657
8/21/2022,Monroe,Michigan,26115,43173,497,43670
8/21/2022,Missaukee,Michigan,26113,3223,65,3288
8/21/2022,Midland,Michigan,26111,21193,235,21428
8/21/2022,Menominee,Michigan,26109,6220,74,6294
8/21/2022,Mecosta,Michigan,26107,9467,115,9582
8/21/2022,Mason,Michigan,26105,7545,97,7642
8/21/2022,Marquette,Michigan,26103,18171,143,18314
8/21/2022,Manistee,Michigan,26101,4985,97,5082
8/21/2022,Macomb,Michigan,26099,265266,4138,269404
8/21/2022,Mackinac,Michigan,26097,2734,32,2766
8/21/2022,Luce,Michigan,26095,2428,17,2445
8/21/2022,Kendall,Texas,48259,9161,127,9288
8/21/2022,Livingston,Michigan,26093,52058,480,52538
8/21/2022,Bibb,Alabama,1007,7166,105,7271
8/21/2022,Barbour,Alabama,1005,6553,101,6654
8/21/2022,Lenawee,Michigan,26091,28993,339,29332
8/21/2022,Leelanau,Michigan,26089,4058,62,4120
8/21/2022,Lapeer,Michigan,26087,22468,434,22902
8/21/2022,Lake,Michigan,26085,2125,39,2164
8/21/2022,Keweenaw,Michigan,26083,605,13,618
8/21/2022,Kent,Michigan,26081,185595,1617,187212
8/21/2022,Kalkaska,Michigan,26079,4086,62,4148
8/21/2022,Kalamazoo,Michigan,26077,68236,709,68945
8/21/2022,Jackson,Michigan,26075,49612,623,50235
8/21/2022,Isabella,Michigan,26073,16799,222,17021
8/21/2022,Iron,Michigan,26071,3029,88,3117
8/21/2022,Iosco,Michigan,26069,5239,151,5390
8/21/2022,Ionia,Michigan,26067,21003,189,21192
8/21/2022,Ingham,Michigan,26065,74083,810,74893
8/21/2022,Huron,Michigan,26063,8818,149,8967
8/21/2022,Houghton,Michigan,26061,8794,103,8897
8/21/2022,Hillsdale,Michigan,26059,11450,208,11658
8/21/2022,Gratiot,Michigan,26057,14639,199,14838
8/21/2022,Grand Traverse,Michigan,26055,19649,247,19896
8/21/2022,Kenedy,Texas,48261,95,2,97
8/21/2022,Gogebic,Michigan,26053,3771,73,3844
8/21/2022,Gladwin,Michigan,26051,6078,122,6200
8/21/2022,Genesee,Michigan,26049,113228,1820,115048
8/21/2022,Emmet,Michigan,26047,7053,95,7148
8/21/2022,Eaton,Michigan,26045,30646,425,31071
8/21/2022,Dickinson,Michigan,26043,8206,116,8322
8/21/2022,Delta,Michigan,26041,11001,164,11165
8/21/2022,Crawford,Michigan,26039,2896,35,2931
8/21/2022,Kent,Texas,48263,215,4,219
8/21/2022,Clinton,Michigan,26037,24299,214,24513
8/21/2022,Baldwin,Alabama,1003,63514,693,64207
8/21/2022,Clare,Michigan,26035,7430,160,7590
8/21/2022,Chippewa,Michigan,26033,12514,124,12638
8/21/2022,Cheboygan,Michigan,26031,5266,119,5385
8/21/2022,Charlevoix,Michigan,26029,5409,61,5470
8/21/2022,Autauga,Alabama,1001,17864,222,18086
8/21/2022,Halifax,Virginia,51083,8443,170,8613
8/21/2022,Waukesha,Wisconsin,55133,127924,1140,129064
8/21/2022,Island,Washington,53029,12352,91,12443
8/21/2022,Jefferson,Washington,53031,4109,30,4139
8/21/2022,Ritchie,West Virginia,54085,2745,31,2776
8/21/2022,Cass,Michigan,26027,11977,153,12130
8/21/2022,Calhoun,Michigan,26025,38130,607,38737
8/21/2022,Kerr,Texas,48265,10373,189,10562
8/21/2022,Branch,Michigan,26023,13171,217,13388
8/21/2022,Berrien,Michigan,26021,38389,602,38991
8/21/2022,Benzie,Michigan,26019,3836,74,3910
8/21/2022,Bay,Michigan,26017,29452,608,30060
8/21/2022,Barry,Michigan,26015,15583,177,15760
8/21/2022,Baraga,Michigan,26013,2473,57,2530
8/21/2022,Arenac,Michigan,26011,3513,74,3587
8/21/2022,Antrim,Michigan,26009,4873,70,4943
8/21/2022,Alpena,Michigan,26007,6047,143,6190
8/21/2022,Allegan,Michigan,26005,29808,369,30177
8/21/2022,Alger,Michigan,26003,2070,15,2085
8/21/2022,Alcona,Michigan,26001,1816,73,1889
8/21/2022,Worcester,Massachusetts,25027,218401,2710,221111
8/21/2022,Unknown,Massachusetts,,167926,25,167951
8/21/2022,Suffolk,Massachusetts,25025,246457,2066,248523
8/21/2022,Plymouth,Massachusetts,25023,130343,1756,132099
8/21/2022,Norfolk,Massachusetts,25021,157086,2007,159093
8/21/2022,Nantucket,Massachusetts,25019,3683,0,3683
8/21/2022,Middlesex,Massachusetts,25017,395054,4220,399274
8/21/2022,Hampshire,Massachusetts,25015,35048,377,35425
8/21/2022,Hampden,Massachusetts,25013,152827,1882,154709
8/21/2022,Franklin,Massachusetts,25011,12874,159,13033
8/21/2022,Essex,Massachusetts,25009,233090,2856,235946
8/21/2022,Dukes,Massachusetts,25007,4054,0,4054
8/21/2022,Bristol,Massachusetts,25005,166574,2242,168816
8/21/2022,Berkshire,Massachusetts,25003,30480,409,30889
8/21/2022,Barnstable,Massachusetts,25001,42557,633,43190
8/21/2022,Worcester,Maryland,24047,9888,167,10055
8/21/2022,Wicomico,Maryland,24045,22469,341,22810
8/21/2022,Washington,Maryland,24043,38131,600,38731
8/21/2022,Unknown,Maryland,,0,32,32
8/21/2022,Talbot,Maryland,24041,6419,94,6513
8/21/2022,St. Mary's,Maryland,24037,21932,230,22162
8/21/2022,Somerset,Maryland,24039,5692,76,5768
8/21/2022,Queen Anne's,Maryland,24035,8028,118,8146
8/21/2022,Prince George's,Maryland,24033,201597,2226,203823
8/21/2022,Montgomery,Maryland,24031,215632,2134,217766
8/21/2022,Kent,Maryland,24029,3572,73,3645
8/21/2022,Kimble,Texas,48267,813,15,828
8/21/2022,Howard,Maryland,24027,55906,394,56300
8/21/2022,Harford,Maryland,24025,44357,603,44960
8/21/2022,Garrett,Maryland,24023,6353,117,6470
8/21/2022,Frederick,Maryland,24021,52619,544,53163
8/21/2022,Dorchester,Maryland,24019,8650,112,8762
8/21/2022,King,Texas,48269,52,0,52
8/21/2022,Kinney,Texas,48271,795,12,807
8/21/2022,Charles,Maryland,24017,33902,368,34270
8/21/2022,Cecil,Maryland,24015,17991,268,18259
8/21/2022,Carroll,Maryland,24013,25003,424,25427
8/21/2022,Caroline,Maryland,24011,6677,83,6760
8/21/2022,Calvert,Maryland,24009,13114,153,13267
8/21/2022,Baltimore city,Maryland,24510,132778,1849,134627
8/21/2022,Baltimore,Maryland,24005,153728,2586,156314
8/21/2022,Anne Arundel,Maryland,24003,106934,1143,108077
8/21/2022,Allegany,Maryland,24001,19214,372,19586
8/21/2022,York,Maine,23031,46386,310,46696
8/21/2022,Washington,Maine,23029,4981,60,5041
8/21/2022,Waldo,Maine,23027,7143,63,7206
8/21/2022,Unknown,Maine,,6,0,6
8/21/2022,Somerset,Maine,23025,11105,115,11220
8/21/2022,Sagadahoc,Maine,23023,6153,39,6192
8/21/2022,Piscataquis,Maine,23021,3395,34,3429
8/21/2022,Penobscot,Maine,23019,32602,351,32953
8/21/2022,Oxford,Maine,23017,12974,154,13128
8/21/2022,Lincoln,Maine,23015,6174,40,6214
8/21/2022,Knox,Maine,23013,7168,41,7209
8/21/2022,Kennebec,Maine,23011,26771,256,27027
8/21/2022,Hancock,Maine,23009,8907,94,9001
8/21/2022,Franklin,Maine,23007,6584,65,6649
8/21/2022,Cumberland,Maine,23005,58890,399,59289
8/21/2022,Aroostook,Maine,23003,16044,181,16225
8/21/2022,Androscoggin,Maine,23001,25120,297,25417
8/21/2022,Winn,Louisiana,22127,4967,65,5032
8/21/2022,West Feliciana,Louisiana,22125,3064,48,3112
8/21/2022,West Carroll,Louisiana,22123,4197,70,4267
8/21/2022,Kleberg,Texas,48273,8441,150,8591
8/21/2022,West Baton Rouge,Louisiana,22121,8230,93,8323
8/21/2022,Webster,Louisiana,22119,13062,192,13254
8/21/2022,Washington,Louisiana,22117,14838,262,15100
8/21/2022,Vernon,Louisiana,22115,10889,192,11081
8/21/2022,Vermilion,Louisiana,22113,17342,233,17575
8/21/2022,Unknown,Louisiana,,1127,0,1127
8/21/2022,Union,Louisiana,22111,8036,140,8176
8/21/2022,Terrebonne,Louisiana,22109,35769,426,36195
8/21/2022,Tensas,Louisiana,22107,1157,13,1170
8/21/2022,Tangipahoa,Louisiana,22105,39915,625,40540
8/21/2022,St. Tammany,Louisiana,22103,83156,876,84032
8/21/2022,St. Mary,Louisiana,22101,14104,273,14377
8/21/2022,St. Martin,Louisiana,22099,14103,192,14295
8/21/2022,St. Landry,Louisiana,22097,25219,421,25640
8/21/2022,St. John the Baptist,Louisiana,22095,12186,185,12371
8/21/2022,St. James,Louisiana,22093,6711,78,6789
8/21/2022,St. Helena,Louisiana,22091,2071,25,2096
8/21/2022,Knox,Texas,48275,566,25,591
8/21/2022,St. Charles,Louisiana,22089,15824,148,15972
8/21/2022,St. Bernard,Louisiana,22087,13031,114,13145
8/21/2022,Sabine,Louisiana,22085,7312,117,7429
8/21/2022,Richland,Louisiana,22083,7806,104,7910
8/21/2022,Red River,Louisiana,22081,2361,54,2415
8/21/2022,Rapides,Louisiana,22079,36918,591,37509
8/21/2022,Pointe Coupee,Louisiana,22077,7224,94,7318
8/21/2022,Plaquemines,Louisiana,22075,7280,48,7328
8/21/2022,Ouachita,Louisiana,22073,57147,781,57928
8/21/2022,Orleans,Louisiana,22071,103887,1155,105042
8/21/2022,Natchitoches,Louisiana,22069,11828,177,12005
8/21/2022,Morehouse,Louisiana,22067,7868,136,8004
8/21/2022,Madison,Louisiana,22065,3625,58,3683
8/21/2022,Livingston,Louisiana,22063,40712,475,41187
8/21/2022,Lincoln,Louisiana,22061,13848,150,13998
8/21/2022,LaSalle,Louisiana,22059,4722,64,4786
8/21/2022,Lafourche,Louisiana,22057,31792,385,32177
8/21/2022,Lafayette,Louisiana,22055,70493,514,71007
8/21/2022,Jefferson Davis,Louisiana,22053,7682,166,7848
8/21/2022,Jefferson,Louisiana,22051,130827,1382,132209
8/21/2022,Jackson,Louisiana,22049,5016,77,5093
8/21/2022,Iberville,Louisiana,22047,10563,153,10716
8/21/2022,Iberia,Louisiana,22045,21981,269,22250
8/21/2022,Grant,Louisiana,22043,6616,95,6711
8/21/2022,Lamar,Texas,48277,13867,262,14129
8/21/2022,Franklin,Louisiana,22041,8100,182,8282
8/21/2022,Evangeline,Louisiana,22039,9525,161,9686
8/21/2022,East Feliciana,Louisiana,22037,7790,173,7963
8/21/2022,Hampton city,Virginia,51650,33566,345,33911
8/21/2022,East Carroll,Louisiana,22035,2895,38,2933
8/21/2022,Prince William,Virginia,51153,113218,768,113986
8/21/2022,East Baton Rouge,Louisiana,22033,125833,1382,127215
8/21/2022,De Soto,Louisiana,22031,8715,139,8854
8/21/2022,Concordia,Louisiana,22029,5749,91,5840
8/21/2022,Claiborne,Louisiana,22027,3696,79,3775
8/21/2022,Catahoula,Louisiana,22025,2917,58,2975
8/21/2022,Cameron,Louisiana,22023,1294,8,1302
8/21/2022,Caldwell,Louisiana,22021,4018,55,4073
8/21/2022,Calcasieu,Louisiana,22019,61201,718,61919
8/21/2022,Caddo,Louisiana,22017,78527,1185,79712
8/21/2022,Bossier,Louisiana,22015,44800,510,45310
8/21/2022,Bienville,Louisiana,22013,4480,114,4594
8/21/2022,Beauregard,Louisiana,22011,10310,144,10454
8/21/2022,Avoyelles,Louisiana,22009,13134,214,13348
8/21/2022,Assumption,Louisiana,22007,6246,70,6316
8/21/2022,Ascension,Louisiana,22005,38872,300,39172
8/21/2022,Allen,Louisiana,22003,8587,142,8729
8/21/2022,Acadia,Louisiana,22001,17622,298,17920
8/21/2022,Woodford,Kentucky,21239,8169,53,8222
8/21/2022,Wolfe,Kentucky,21237,2934,29,2963
8/21/2022,Whitley,Kentucky,21235,15054,213,15267
8/21/2022,Webster,Kentucky,21233,4348,50,4398
8/21/2022,Wayne,Kentucky,21231,6770,95,6865
8/21/2022,Lamb,Texas,48279,4699,123,4822
8/21/2022,Lampasas,Texas,48281,5967,93,6060
8/21/2022,Washington,Kentucky,21229,4448,63,4511
8/21/2022,Warren,Kentucky,21227,48066,389,48455
8/21/2022,Union,Kentucky,21225,4860,58,4918
8/21/2022,Trimble,Kentucky,21223,2370,43,2413
8/21/2022,Trigg,Kentucky,21221,4506,45,4551
8/21/2022,Todd,Kentucky,21219,3196,46,3242
8/21/2022,Taylor,Kentucky,21217,10492,130,10622
8/21/2022,Spencer,Kentucky,21215,6073,64,6137
8/21/2022,Simpson,Kentucky,21213,6380,96,6476
8/21/2022,Shelby,Kentucky,21211,15059,169,15228
8/21/2022,Scott,Kentucky,21209,20401,116,20517
8/21/2022,Russell,Kentucky,21207,7134,90,7224
8/21/2022,Rusk,Wisconsin,55107,3803,59,3862
8/21/2022,Lincoln,West Virginia,54043,6340,85,6425
8/21/2022,Rowan,Kentucky,21205,7908,74,7982
8/21/2022,Rockcastle,Kentucky,21203,5580,63,5643
8/21/2022,Robertson,Kentucky,21201,758,21,779
8/21/2022,La Salle,Texas,48283,2511,49,2560
8/21/2022,Pulaski,Kentucky,21199,19956,301,20257
8/21/2022,Powell,Kentucky,21197,5346,45,5391
8/21/2022,Pike,Kentucky,21195,21722,330,22052
8/21/2022,Perry,Kentucky,21193,12993,190,13183
8/21/2022,Pendleton,Kentucky,21191,3749,40,3789
8/21/2022,Owsley,Kentucky,21189,1729,30,1759
8/21/2022,Lavaca,Texas,48285,4557,123,4680
8/21/2022,Owen,Kentucky,21187,2725,35,2760
8/21/2022,Oldham,Kentucky,21185,20650,148,20798
8/21/2022,Ohio,Kentucky,21183,8094,105,8199
8/21/2022,Nicholas,Kentucky,21181,2368,32,2400
8/21/2022,Nelson,Kentucky,21179,16479,159,16638
8/21/2022,Muhlenberg,Kentucky,21177,11537,127,11664
8/21/2022,Morgan,Kentucky,21175,5851,33,5884
8/21/2022,Montgomery,Kentucky,21173,9901,110,10011
8/21/2022,Monroe,Kentucky,21171,4011,84,4095
8/21/2022,Metcalfe,Kentucky,21169,3242,69,3311
8/21/2022,Mercer,Kentucky,21167,8283,109,8392
8/21/2022,Lee,Texas,48287,4779,62,4841
8/21/2022,Menifee,Kentucky,21165,1963,34,1997
8/21/2022,Meade,Kentucky,21163,6553,67,6620
8/21/2022,McLean,Kentucky,21149,2934,54,2988
8/21/2022,McCreary,Kentucky,21147,6468,84,6552
8/21/2022,McCracken,Kentucky,21145,21870,288,22158
8/21/2022,Mason,Kentucky,21161,5599,110,5709
8/21/2022,Martin,Kentucky,21159,3671,49,3720
8/21/2022,Marshall,Kentucky,21157,9139,119,9258
8/21/2022,Marion,Kentucky,21155,7123,86,7209
8/21/2022,Magoffin,Kentucky,21153,4483,55,4538
8/21/2022,Madison,Kentucky,21151,31224,289,31513
8/21/2022,Lyon,Kentucky,21143,3414,37,3451
8/21/2022,Logan,Kentucky,21141,9173,129,9302
8/21/2022,Leon,Texas,48289,3997,94,4091
8/21/2022,Livingston,Kentucky,21139,2811,62,2873
8/21/2022,Lincoln,Kentucky,21137,7568,139,7707
8/21/2022,Lewis,Kentucky,21135,5034,89,5123
8/21/2022,Letcher,Kentucky,21133,8262,125,8387
8/21/2022,Leslie,Kentucky,21131,4339,50,4389
8/21/2022,Lee,Kentucky,21129,3155,56,3211
8/21/2022,Lawrence,Kentucky,21127,4980,76,5056
8/21/2022,Laurel,Kentucky,21125,23059,257,23316
8/21/2022,Larue,Kentucky,21123,4225,74,4299
8/21/2022,Knox,Kentucky,21121,12993,154,13147
8/21/2022,Knott,Kentucky,21119,5032,67,5099
8/21/2022,Kenton,Kentucky,21117,51171,447,51618
8/21/2022,Johnson,Kentucky,21115,7430,126,7556
8/21/2022,Jessamine,Kentucky,21113,17043,150,17193
8/21/2022,Jefferson,Kentucky,21111,269354,2467,271821
8/21/2022,Jackson,Kentucky,21109,4677,83,4760
8/21/2022,Hopkins,Kentucky,21107,16883,261,17144
8/21/2022,Hickman,Kentucky,21105,968,29,997
8/21/2022,Henry,Kentucky,21103,5613,54,5667
8/21/2022,Henderson,Kentucky,21101,15647,177,15824
8/21/2022,Hart,Kentucky,21099,6016,108,6124
8/21/2022,Harrison,Kentucky,21097,7484,85,7569
8/21/2022,Harlan,Kentucky,21095,10276,216,10492
8/21/2022,Hardin,Kentucky,21093,38127,458,38585
8/21/2022,Hancock,Kentucky,21091,2776,26,2802
8/21/2022,Greenup,Kentucky,21089,14165,152,14317
8/21/2022,Green,Kentucky,21087,4097,47,4144
8/21/2022,Grayson,Kentucky,21085,8856,139,8995
8/21/2022,Graves,Kentucky,21083,12486,187,12673
8/21/2022,Grant,Kentucky,21081,8803,68,8871
8/21/2022,Garrard,Kentucky,21079,5319,83,5402
8/21/2022,Gallatin,Kentucky,21077,2405,54,2459
8/21/2022,Fulton,Kentucky,21075,1343,33,1376
8/21/2022,Liberty,Texas,48291,20469,408,20877
8/21/2022,Franklin,Kentucky,21073,16088,162,16250
8/21/2022,Floyd,Kentucky,21071,14298,227,14525
8/21/2022,Fleming,Kentucky,21069,4417,65,4482
8/21/2022,Fayette,Kentucky,21067,109330,639,109969
8/21/2022,Estill,Kentucky,21065,4487,52,4539
8/21/2022,Elliott,Kentucky,21063,3051,20,3071
8/21/2022,Edmonson,Kentucky,21061,2846,50,2896
8/21/2022,Daviess,Kentucky,21059,34712,402,35114
8/21/2022,Cumberland,Kentucky,21057,2447,33,2480
8/21/2022,Crittenden,Kentucky,21055,2569,52,2621
8/21/2022,Clinton,Kentucky,21053,4122,54,4176
8/21/2022,Clay,Kentucky,21051,8487,97,8584
8/21/2022,Clark,Kentucky,21049,12402,75,12477
8/21/2022,Christian,Kentucky,21047,18079,217,18296
8/21/2022,Casey,Kentucky,21045,4631,76,4707
8/21/2022,Carter,Kentucky,21043,10092,111,10203
8/21/2022,Carroll,Kentucky,21041,3787,51,3838
8/21/2022,Lincoln,Wisconsin,55069,8037,153,8190
8/21/2022,Carlisle,Kentucky,21039,1198,20,1218
8/21/2022,Campbell,Kentucky,21037,27925,192,28117
8/21/2022,Calloway,Kentucky,21035,10247,98,10345
8/21/2022,Caldwell,Kentucky,21033,4571,63,4634
8/21/2022,Butler,Kentucky,21031,4178,55,4233
8/21/2022,Limestone,Texas,48293,5567,127,5694
8/21/2022,Bullitt,Kentucky,21029,25075,233,25308
8/21/2022,Breckinridge,Kentucky,21027,5745,85,5830
8/21/2022,Breathitt,Kentucky,21025,4476,56,4532
8/21/2022,Bracken,Kentucky,21023,2454,28,2482
8/21/2022,Boyle,Kentucky,21021,9951,143,10094
8/21/2022,Boyd,Kentucky,21019,19194,187,19381
8/21/2022,Bourbon,Kentucky,21017,6840,62,6902
8/21/2022,Boone,Kentucky,21015,44265,316,44581
8/21/2022,Bell,Kentucky,21013,9754,161,9915
8/21/2022,Bath,Kentucky,21011,3738,49,3787
8/21/2022,Barren,Kentucky,21009,14506,226,14732
8/21/2022,Ballard,Kentucky,21007,1619,34,1653
8/21/2022,Anderson,Kentucky,21005,7526,74,7600
8/21/2022,Allen,Kentucky,21003,7443,111,7554
8/21/2022,Adair,Kentucky,21001,6704,110,6814
8/21/2022,Wyandotte,Kansas,20209,51082,524,51606
8/21/2022,Woodson,Kansas,20207,885,17,902
8/21/2022,Wilson,Kansas,20205,3085,50,3135
8/21/2022,Wichita,Kansas,20203,537,8,545
8/21/2022,Washington,Kansas,20201,1491,23,1514
8/21/2022,Wallace,Kansas,20199,462,8,470
8/21/2022,Wabaunsee,Kansas,20197,1761,23,1784
8/21/2022,Trego,Kansas,20195,826,12,838
8/21/2022,Thomas,Kansas,20193,2696,29,2725
8/21/2022,Sumner,Kansas,20191,6101,74,6175
8/21/2022,Stevens,Kansas,20189,1661,24,1685
8/21/2022,Stanton,Kansas,20187,446,9,455
8/21/2022,Stafford,Kansas,20185,1243,28,1271
8/21/2022,Smith,Kansas,20183,697,9,706
8/21/2022,Sherman,Kansas,20181,1630,22,1652
8/21/2022,Lipscomb,Texas,48295,753,17,770
8/21/2022,Sheridan,Kansas,20179,819,17,836
8/21/2022,Live Oak,Texas,48297,2287,42,2329
8/21/2022,Shawnee,Kansas,20177,54582,651,55233
8/21/2022,Seward,Kansas,20175,7515,60,7575
8/21/2022,Llano,Texas,48299,4543,97,4640
8/21/2022,Sedgwick,Kansas,20173,157633,1467,159100
8/21/2022,Scott,Kansas,20171,1417,34,1451
8/21/2022,Saline,Kansas,20169,15496,250,15746
8/21/2022,Russell,Kansas,20167,1964,38,2002
8/21/2022,Rush,Kansas,20165,849,19,868
8/21/2022,Rooks,Kansas,20163,1460,21,1481
8/21/2022,Riley,Kansas,20161,14841,91,14932
8/21/2022,Rice,Kansas,20159,2827,28,2855
8/21/2022,Republic,Kansas,20157,1432,19,1451
8/21/2022,Reno,Kansas,20155,20540,245,20785
8/21/2022,Rawlins,Kansas,20153,708,9,717
8/21/2022,Loving,Texas,48301,315,1,316
8/21/2022,Pratt,Kansas,20151,2060,35,2095
8/21/2022,Pottawatomie,Kansas,20149,6341,62,6403
8/21/2022,Phillips,Kansas,20147,1488,30,1518
8/21/2022,Pawnee,Kansas,20145,2351,25,2376
8/21/2022,Ottawa,Kansas,20143,1300,23,1323
8/21/2022,Osborne,Kansas,20141,883,19,902
8/21/2022,Osage,Kansas,20139,4291,61,4352
8/21/2022,Norton,Kansas,20137,2279,36,2315
8/21/2022,Ness,Kansas,20135,806,19,825
8/21/2022,Lubbock,Texas,48303,102551,1353,103904
8/21/2022,Neosho,Kansas,20133,5577,69,5646
8/21/2022,Nemaha,Kansas,20131,3507,60,3567
8/21/2022,Morton,Kansas,20129,654,11,665
8/21/2022,Morris,Kansas,20127,1606,30,1636
8/21/2022,Montgomery,Kansas,20125,10104,166,10270
8/21/2022,Mitchell,Kansas,20123,1560,24,1584
8/21/2022,Miami,Kansas,20121,8676,100,8776
8/21/2022,Meade,Kansas,20119,1269,22,1291
8/21/2022,McPherson,Kansas,20113,8574,129,8703
8/21/2022,Marshall,Kansas,20117,2713,44,2757
8/21/2022,Marion,Kansas,20115,3596,45,3641
8/21/2022,Lyon,Kansas,20111,10828,126,10954
8/21/2022,Logan,Kansas,20109,904,13,917
8/21/2022,Lynn,Texas,48305,1613,39,1652
8/21/2022,Madison,Texas,48313,4012,58,4070
8/21/2022,Marion,Texas,48315,1834,61,1895
8/21/2022,Linn,Kansas,20107,3097,32,3129
8/21/2022,Lincoln,Kansas,20105,657,11,668
8/21/2022,Leavenworth,Kansas,20103,21765,196,21961
8/21/2022,Lane,Kansas,20101,327,12,339
8/21/2022,Labette,Kansas,20099,7124,80,7204
8/21/2022,Kiowa,Kansas,20097,703,7,710
8/21/2022,Kingman,Kansas,20095,2109,28,2137
8/21/2022,Kearny,Kansas,20093,1330,21,1351
8/21/2022,Johnson,Kansas,20091,164687,1251,165938
8/21/2022,Martin,Texas,48317,1325,26,1351
8/21/2022,Jewell,Kansas,20089,857,15,872
8/21/2022,Jefferson,Kansas,20087,5252,68,5320
8/21/2022,Jackson,Kansas,20085,4241,31,4272
8/21/2022,Hodgeman,Kansas,20083,451,11,462
8/21/2022,Wise,Virginia,51195,12307,204,12511
8/21/2022,Wythe,Virginia,51197,8565,155,8720
8/21/2022,Haskell,Kansas,20081,1014,12,1026
8/21/2022,Harvey,Kansas,20079,10681,124,10805
8/21/2022,Iowa,Wisconsin,55049,6149,31,6180
8/21/2022,Whitman,Washington,53075,9580,96,9676
8/21/2022,Hanover,Virginia,51085,25572,310,25882
8/21/2022,Adams,Wisconsin,55001,5240,65,5305
8/21/2022,Crawford,Wisconsin,55023,4791,31,4822
8/21/2022,Mason,Texas,48319,899,13,912
8/21/2022,Pulaski,Virginia,51155,8437,142,8579
8/21/2022,Harrisonburg city,Virginia,51660,14465,165,14630
8/21/2022,Dane,Wisconsin,55025,159484,550,160034
8/21/2022,Logan,West Virginia,54045,11349,191,11540
8/21/2022,Henrico,Virginia,51087,79489,987,80476
8/21/2022,Vilas,Wisconsin,55125,5904,91,5995
8/21/2022,Ashland,Wisconsin,55003,3786,39,3825
8/21/2022,York,Virginia,51199,11963,114,12077
8/21/2022,Marion,West Virginia,54049,17636,185,17821
8/21/2022,Matagorda,Texas,48321,9574,178,9752
8/21/2022,Yakima,Washington,53077,80741,823,81564
8/21/2022,Roane,West Virginia,54087,3813,41,3854
8/21/2022,Maverick,Texas,48323,22994,471,23465
8/21/2022,Outagamie,Wisconsin,55087,59717,422,60139
8/21/2022,McCulloch,Texas,48307,1553,47,1600
8/21/2022,King,Washington,53033,502369,3073,505442
8/21/2022,Harper,Kansas,20077,1752,28,1780
8/21/2022,McLennan,Texas,48309,67511,923,68434
8/21/2022,Hamilton,Kansas,20075,519,3,522
8/21/2022,Greenwood,Kansas,20073,1935,24,1959
8/21/2022,Marshall,West Virginia,54051,10293,161,10454
8/21/2022,Walworth,Wisconsin,55127,29816,290,30106
8/21/2022,Teton,Wyoming,56039,11439,16,11455
8/21/2022,Greeley,Kansas,20071,367,3,370
8/21/2022,Gray,Kansas,20069,1290,22,1312
8/21/2022,Henry,Virginia,51089,14236,277,14513
8/21/2022,Kitsap,Washington,53035,47671,380,48051
8/21/2022,Highland,Virginia,51091,437,7,444
8/21/2022,Grant,Kansas,20067,2481,37,2518
8/21/2022,Graham,Kansas,20065,616,15,631
8/21/2022,Gove,Kansas,20063,863,23,886
8/21/2022,Geary,Kansas,20061,10244,78,10322
8/21/2022,Radford city,Virginia,51750,5603,54,5657
8/21/2022,Rappahannock,Virginia,51157,1184,10,1194
8/21/2022,McMullen,Texas,48311,180,9,189
8/21/2022,Barron,Wisconsin,55005,14883,147,15030
8/21/2022,Manitowoc,Wisconsin,55071,22716,195,22911
8/21/2022,Medina,Texas,48325,11244,205,11449
8/21/2022,Richmond,Virginia,51159,2708,25,2733
8/21/2022,Menard,Texas,48327,582,12,594
8/21/2022,St. Croix,Virgin Islands,78010,11262,52,11314
8/21/2022,Franklin,Kansas,20059,7491,92,7583
8/21/2022,Ford,Kansas,20057,11465,117,11582
8/21/2022,Finney,Kansas,20055,12454,117,12571
8/21/2022,Midland,Texas,48329,44258,502,44760
8/21/2022,St. John,Virgin Islands,78020,994,5,999
8/21/2022,Iron,Wisconsin,55051,1619,48,1667
8/21/2022,St. Thomas,Virgin Islands,78030,9879,65,9944
8/21/2022,Milam,Texas,48331,5480,106,5586
8/21/2022,Price,Wisconsin,55099,3645,34,3679
8/21/2022,Mills,Texas,48333,1514,37,1551
8/21/2022,Ellsworth,Kansas,20053,2210,32,2242
8/21/2022,Mitchell,Texas,48335,2002,50,2052
8/21/2022,Montague,Texas,48337,4980,130,5110
8/21/2022,Ellis,Kansas,20051,7667,86,7753
8/21/2022,Elk,Kansas,20049,618,12,630
8/21/2022,Edwards,Kansas,20047,619,14,633
8/21/2022,Douglas,Kansas,20045,30845,144,30989
8/21/2022,Mason,West Virginia,54053,7816,101,7917
8/21/2022,Richmond city,Virginia,51760,54619,528,55147
8/21/2022,Montgomery,Texas,48339,160359,1323,161682
8/21/2022,Moore,Texas,48341,6005,113,6118
8/21/2022,Morris,Texas,48343,2751,74,2825
8/21/2022,Jackson,Wisconsin,55053,6239,43,6282
8/21/2022,Roanoke,Virginia,51161,24770,295,25065
8/21/2022,Kittitas,Washington,53037,9690,81,9771
8/21/2022,Motley,Texas,48345,303,13,316
8/21/2022,Hopewell city,Virginia,51670,6973,119,7092
8/21/2022,Barbour,West Virginia,54001,5451,76,5527
8/21/2022,Berkeley,West Virginia,54003,40317,318,40635
8/21/2022,Laramie,Wyoming,56021,29549,302,29851
8/21/2022,Roanoke city,Virginia,51770,24917,388,25305
8/21/2022,Summers,West Virginia,54089,3278,57,3335
8/21/2022,Nacogdoches,Texas,48347,13567,267,13834
8/21/2022,Ozaukee,Wisconsin,55089,25506,192,25698
8/21/2022,Doniphan,Kansas,20043,2644,35,2679
8/21/2022,Taylor,Wisconsin,55119,5263,73,5336
8/21/2022,Rockbridge,Virginia,51163,4469,88,4557
8/21/2022,Dickinson,Kansas,20041,5297,86,5383
8/21/2022,Decatur,Kansas,20039,654,20,674
8/21/2022,Crawford,Kansas,20037,13343,131,13474
8/21/2022,Cowley,Kansas,20035,11291,161,11452
8/21/2022,Comanche,Kansas,20033,457,17,474
8/21/2022,Coffey,Kansas,20031,2592,44,2636
8/21/2022,Cloud,Kansas,20029,2401,43,2444
8/21/2022,Navarro,Texas,48349,13331,223,13554
8/21/2022,Clay,Kansas,20027,2177,39,2216
8/21/2022,Clark,Kansas,20025,527,8,535
8/21/2022,Cheyenne,Kansas,20023,678,14,692
8/21/2022,Cherokee,Kansas,20021,6688,89,6777
8/21/2022,Chautauqua,Kansas,20019,901,18,919
8/21/2022,Newton,Texas,48351,1603,62,1665
8/21/2022,Chase,Kansas,20017,736,7,743
8/21/2022,Butler,Kansas,20015,20555,199,20754
8/21/2022,Brown,Kansas,20013,2948,49,2997
8/21/2022,Bourbon,Kansas,20011,4969,55,5024
8/21/2022,Barton,Kansas,20009,6943,108,7051
8/21/2022,Barber,Kansas,20007,1113,9,1122
8/21/2022,Atchison,Kansas,20005,4666,38,4704
8/21/2022,Anderson,Kansas,20003,2331,35,2366
8/21/2022,Allen,Kansas,20001,4465,58,4523
8/21/2022,Nolan,Texas,48353,3354,100,3454
8/21/2022,Wright,Iowa,19197,3809,67,3876
8/21/2022,Worth,Iowa,19195,1893,17,1910
8/21/2022,Woodbury,Iowa,19193,30840,345,31185
8/21/2022,Winneshiek,Iowa,19191,4227,54,4281
8/21/2022,Nueces,Texas,48355,105924,1536,107460
8/21/2022,Winnebago,Iowa,19189,3223,47,3270
8/21/2022,Webster,Iowa,19187,11250,169,11419
8/21/2022,Wayne,Iowa,19185,1379,33,1412
8/21/2022,Ochiltree,Texas,48357,2560,48,2608
8/21/2022,Jefferson,Wisconsin,55055,24201,248,24449
8/21/2022,Klickitat,Washington,53039,4058,51,4109
8/21/2022,Boone,West Virginia,54005,7672,85,7757
8/21/2022,Oldham,Texas,48359,594,6,600
8/21/2022,Isle of Wight,Virginia,51093,8240,120,8360
8/21/2022,James City,Virginia,51095,18461,128,18589
8/21/2022,Washington,Iowa,19183,6179,80,6259
8/21/2022,Warren,Iowa,19181,13511,137,13648
8/21/2022,Wapello,Iowa,19179,9645,212,9857
8/21/2022,Van Buren,Iowa,19177,1507,27,1534
8/21/2022,Unknown,Iowa,,254,0,254
8/21/2022,Adams,Washington,53001,5410,40,5450
8/21/2022,Orange,Texas,48361,16381,364,16745
8/21/2022,Rockingham,Virginia,51165,16226,240,16466
8/21/2022,Palo Pinto,#ERROR!,48363,7551,155,7706
8/21/2022,Braxton,West Virginia,54007,4568,48,4616
8/21/2022,Waupaca,Wisconsin,55135,14902,257,15159
8/21/2022,Russell,Virginia,51167,7789,118,7907
8/21/2022,Panola,Texas,48365,5089,132,5221
8/21/2022,King and Queen,Virginia,51097,1300,12,1312
8/21/2022,McDowell,West Virginia,54047,6591,77,6668
8/21/2022,Parker,Texas,48367,37664,462,38126
8/21/2022,King George,Virginia,51099,6028,46,6074
8/21/2022,Union,Iowa,19175,2929,53,2982
8/21/2022,Taylor,Iowa,19173,1401,22,1423
8/21/2022,King William,Virginia,51101,4215,46,4261
8/21/2022,Taylor,West Virginia,54091,5203,73,5276
8/21/2022,Lewis,Washington,53041,19615,277,19892
8/21/2022,Trempealeau,Wisconsin,55121,9175,67,9242
8/21/2022,Shawano,Wisconsin,55115,12829,156,12985
8/21/2022,Tama,Iowa,19171,4262,95,4357
8/21/2022,Story,Iowa,19169,21521,92,21613
8/21/2022,Sioux,Iowa,19167,8380,90,8470
8/21/2022,Shelby,Iowa,19165,2919,52,2971
8/21/2022,Scott,Iowa,19163,45250,413,45663
8/21/2022,Sac,Iowa,19161,2647,37,2684
8/21/2022,Ringgold,Iowa,19159,1203,36,1239
8/21/2022,Poweshiek,Iowa,19157,4157,63,4220
8/21/2022,Pottawattamie,Iowa,19155,25992,323,26315